CCGTAAATAAG -> CGTAAATAAGT
CGTAAATAAGT -> GTAAATAAGTC
GTAAATAAGTC -> TAAATAAGTCC
TAAATAAGTCC -> AAATAAGTCCG
AAATAAGTCCG -> AATAAGTCCGG
AATAAGTCCGG -> ATAAGTCCGGG
ATAAGTCCGGG -> TAAGTCCGGGG
TAAGTCCGGGG -> AAGTCCGGGGT
AAGTCCGGGGT -> AGTCCGGGGTT
AGTCCGGGGTT -> GTCCGGGGTTT
GTCCGGGGTTT -> TCCGGGGTTTA
TCCGGGGTTTA -> CCGGGGTTTAA
CCGGGGTTTAA -> CGGGGTTTAAA
CGGGGTTTAAA -> GGGGTTTAAAA
GGGGTTTAAAA -> GGGTTTAAAAG
GGGTTTAAAAG -> GGTTTAAAAGT
GGTTTAAAAGT -> GTTTAAAAGTA
GTTTAAAAGTA -> TTTAAAAGTAG
TTTAAAAGTAG -> TTAAAAGTAGG
TTAAAAGTAGG -> TAAAAGTAGGG
TAAAAGTAGGG -> AAAAGTAGGGT
AAAAGTAGGGT -> AAAGTAGGGTG
AAAGTAGGGTG -> AAGTAGGGTGG
AAGTAGGGTGG -> AGTAGGGTGGA
AGTAGGGTGGA -> GTAGGGTGGAC
GTAGGGTGGAC -> TAGGGTGGACC
TAGGGTGGACC -> AGGGTGGACCT
AGGGTGGACCT -> GGGTGGACCTC
GGGTGGACCTC -> GGTGGACCTCT
GGTGGACCTCT -> GTGGACCTCTA
GTGGACCTCTA -> TGGACCTCTAA
TGGACCTCTAA -> GGACCTCTAAT
GGACCTCTAAT -> GACCTCTAATT
GACCTCTAATT -> ACCTCTAATTA
ACCTCTAATTA -> CCTCTAATTAA
CCTCTAATTAA -> CTCTAATTAAT
CTCTAATTAAT -> TCTAATTAATA
TCTAATTAATA -> CTAATTAATAT
CTAATTAATAT -> TAATTAATATC
TAATTAATATC -> AATTAATATCA
AATTAATATCA -> ATTAATATCAC
ATTAATATCAC -> TTAATATCACC
TTAATATCACC -> TAATATCACCA
TAATATCACCA -> AATATCACCAG
AATATCACCAG -> ATATCACCAGT
ATATCACCAGT -> TATCACCAGTG
TATCACCAGTG -> ATCACCAGTGA
ATCACCAGTGA -> TCACCAGTGAG
TCACCAGTGAG -> CACCAGTGAGA
CACCAGTGAGA -> ACCAGTGAGAG
ACCAGTGAGAG -> CCAGTGAGAGA
CCAGTGAGAGA -> CAGTGAGAGAG
CAGTGAGAGAG -> AGTGAGAGAGG
AGTGAGAGAGG -> GTGAGAGAGGG
GTGAGAGAGGG -> TGAGAGAGGGT
TGAGAGAGGGT -> GAGAGAGGGTT
GAGAGAGGGTT -> AGAGAGGGTTA
AGAGAGGGTTA -> GAGAGGGTTAA
GAGAGGGTTAA -> AGAGGGTTAAG
AGAGGGTTAAG -> GAGGGTTAAGC
GAGGGTTAAGC -> AGGGTTAAGCC
AGGGTTAAGCC -> GGGTTAAGCCA
GGGTTAAGCCA -> GGTTAAGCCAT
GGTTAAGCCAT -> GTTAAGCCATC
GTTAAGCCATC -> TTAAGCCATCT
TTAAGCCATCT -> TAAGCCATCTT
TAAGCCATCTT -> AAGCCATCTTT
AAGCCATCTTT -> AGCCATCTTTT
AGCCATCTTTT -> GCCATCTTTTA
GCCATCTTTTA -> CCATCTTTTAC
CCATCTTTTAC -> CATCTTTTACC
CATCTTTTACC -> ATCTTTTACCT
ATCTTTTACCT -> TCTTTTACCTT
TCTTTTACCTT -> CTTTTACCTTA
CTTTTACCTTA -> TTTTACCTTAG
TTTTACCTTAG -> TTTACCTTAGA
TTTACCTTAGA -> TTACCTTAGAA
TTACCTTAGAA -> TACCTTAGAAA
TACCTTAGAAA -> ACCTTAGAAAC
ACCTTAGAAAC -> CCTTAGAAACC
CCTTAGAAACC -> CTTAGAAACCT
CTTAGAAACCT -> TTAGAAACCTT
TTAGAAACCTT -> TAGAAACCTTA
TAGAAACCTTA -> AGAAACCTTAG
AGAAACCTTAG -> GAAACCTTAGA
GAAACCTTAGA -> AAACCTTAGAT
AAACCTTAGAT -> AACCTTAGATC
AACCTTAGATC -> ACCTTAGATCG
ACCTTAGATCG -> CCTTAGATCGT
CCTTAGATCGT -> CTTAGATCGTG
CTTAGATCGTG -> TTAGATCGTGT
TTAGATCGTGT -> TAGATCGTGTG
TAGATCGTGTG -> AGATCGTGTGG
AGATCGTGTGG -> GATCGTGTGGC
GATCGTGTGGC -> ATCGTGTGGCC
ATCGTGTGGCC -> TCGTGTGGCCA
TCGTGTGGCCA -> CGTGTGGCCAG
CGTGTGGCCAG -> GTGTGGCCAGA
GTGTGGCCAGA -> TGTGGCCAGAG
TGTGGCCAGAG -> GTGGCCAGAGT
GTGGCCAGAGT -> TGGCCAGAGTT
TGGCCAGAGTT -> GGCCAGAGTTA
GGCCAGAGTTA -> GCCAGAGTTAT
GCCAGAGTTAT -> CCAGAGTTATA
CCAGAGTTATA -> CAGAGTTATAA
CAGAGTTATAA -> AGAGTTATAAC
AGAGTTATAAC -> GAGTTATAACA
GAGTTATAACA -> AGTTATAACAT
AGTTATAACAT -> GTTATAACATA
GTTATAACATA -> TTATAACATAA
TTATAACATAA -> TATAACATAAC
TATAACATAAC -> ATAACATAACG
ATAACATAACG -> TAACATAACGT
TAACATAACGT -> AACATAACGTG
AACATAACGTG -> ACATAACGTGC
ACATAACGTGC -> CATAACGTGCT
CATAACGTGCT -> ATAACGTGCTA
ATAACGTGCTA -> TAACGTGCTAC
TAACGTGCTAC -> AACGTGCTACC
AACGTGCTACC -> ACGTGCTACCC
ACGTGCTACCC -> CGTGCTACCCT
CGTGCTACCCT -> GTGCTACCCTC
GTGCTACCCTC -> TGCTACCCTCG
TGCTACCCTCG -> GCTACCCTCGT
GCTACCCTCGT -> CTACCCTCGTC
CTACCCTCGTC -> TACCCTCGTCT
TACCCTCGTCT -> ACCCTCGTCTG
ACCCTCGTCTG -> CCCTCGTCTGG
CCCTCGTCTGG -> CCTCGTCTGGA
CCTCGTCTGGA -> CTCGTCTGGAG
CTCGTCTGGAG -> TCGTCTGGAGT
TCGTCTGGAGT -> CGTCTGGAGTA
CGTCTGGAGTA -> GTCTGGAGTAG
GTCTGGAGTAG -> TCTGGAGTAGG
TCTGGAGTAGG -> CTGGAGTAGGA
CTGGAGTAGGA -> TGGAGTAGGAG
TGGAGTAGGAG -> GGAGTAGGAGC
GGAGTAGGAGC -> GAGTAGGAGCA
GAGTAGGAGCA -> AGTAGGAGCAG
AGTAGGAGCAG -> GTAGGAGCAGT
GTAGGAGCAGT -> TAGGAGCAGTT
TAGGAGCAGTT -> AGGAGCAGTTG
AGGAGCAGTTG -> GGAGCAGTTGA
GGAGCAGTTGA -> GAGCAGTTGAT
GAGCAGTTGAT -> AGCAGTTGATG
AGCAGTTGATG -> GCAGTTGATGA
GCAGTTGATGA -> CAGTTGATGAT
CAGTTGATGAT -> AGTTGATGATA
AGTTGATGATA -> GTTGATGATAG
GTTGATGATAG -> TTGATGATAGT
TTGATGATAGT -> TGATGATAGTC
TGATGATAGTC -> GATGATAGTCG
GATGATAGTCG -> ATGATAGTCGT
ATGATAGTCGT -> TGATAGTCGTT
TGATAGTCGTT -> GATAGTCGTTA
GATAGTCGTTA -> ATAGTCGTTAC
ATAGTCGTTAC -> TAGTCGTTACC
TAGTCGTTACC -> AGTCGTTACCG
AGTCGTTACCG -> GTCGTTACCGG
GTCGTTACCGG -> TCGTTACCGGG
TCGTTACCGGG -> CGTTACCGGGG
CGTTACCGGGG -> GTTACCGGGGC
GTTACCGGGGC -> TTACCGGGGCG
TTACCGGGGCG -> TACCGGGGCGG
TACCGGGGCGG -> ACCGGGGCGGT
ACCGGGGCGGT -> CCGGGGCGGTA
CCGGGGCGGTA -> CGGGGCGGTAA
CGGGGCGGTAA -> GGGGCGGTAAG
GGGGCGGTAAG -> GGGCGGTAAGT
GGGCGGTAAGT -> GGCGGTAAGTA
GGCGGTAAGTA -> GCGGTAAGTAT
GCGGTAAGTAT -> CGGTAAGTATG
CGGTAAGTATG -> GGTAAGTATGT
GGTAAGTATGT -> GTAAGTATGTA
GTAAGTATGTA -> TAAGTATGTAG
TAAGTATGTAG -> AAGTATGTAGA
AAGTATGTAGA -> AGTATGTAGAG
AGTATGTAGAG -> GTATGTAGAGG
GTATGTAGAGG -> TATGTAGAGGC
TATGTAGAGGC -> ATGTAGAGGCC
ATGTAGAGGCC -> TGTAGAGGCCC
TGTAGAGGCCC -> GTAGAGGCCCT
GTAGAGGCCCT -> TAGAGGCCCTG
TAGAGGCCCTG -> AGAGGCCCTGG
AGAGGCCCTGG -> GAGGCCCTGGC
GAGGCCCTGGC -> AGGCCCTGGCG
AGGCCCTGGCG -> GGCCCTGGCGG
GGCCCTGGCGG -> GCCCTGGCGGA
GCCCTGGCGGA -> CCCTGGCGGAG
CCCTGGCGGAG -> CCTGGCGGAGA
CCTGGCGGAGA -> CTGGCGGAGAA
CTGGCGGAGAA -> TGGCGGAGAAC
TGGCGGAGAAC -> GGCGGAGAACG
GGCGGAGAACG -> GCGGAGAACGG
GCGGAGAACGG -> CGGAGAACGGG
CGGAGAACGGG -> GGAGAACGGGC
GGAGAACGGGC -> GAGAACGGGCG
GAGAACGGGCG -> AGAACGGGCGG
AGAACGGGCGG -> GAACGGGCGGC
GAACGGGCGGC -> AACGGGCGGCC
AACGGGCGGCC -> ACGGGCGGCCA
ACGGGCGGCCA -> CGGGCGGCCAT
CGGGCGGCCAT -> GGGCGGCCATG
GGGCGGCCATG -> GGCGGCCATGC
GGCGGCCATGC -> GCGGCCATGCT
GCGGCCATGCT -> CGGCCATGCTA
CGGCCATGCTA -> GGCCATGCTAC
GGCCATGCTAC -> GCCATGCTACC
GCCATGCTACC -> CCATGCTACCG
CCATGCTACCG -> CATGCTACCGA
CATGCTACCGA -> ATGCTACCGAT
ATGCTACCGAT -> TGCTACCGATA
TGCTACCGATA -> GCTACCGATAA
GCTACCGATAA -> CTACCGATAAT
CTACCGATAAT -> TACCGATAATG
TACCGATAATG -> ACCGATAATGG
ACCGATAATGG -> CCGATAATGGT
CCGATAATGGT -> CGATAATGGTA
CGATAATGGTA -> GATAATGGTAG
GATAATGGTAG -> ATAATGGTAGA
ATAATGGTAGA -> TAATGGTAGAG
TAATGGTAGAG -> AATGGTAGAGG
AATGGTAGAGG -> ATGGTAGAGGT
ATGGTAGAGGT -> TGGTAGAGGTA
TGGTAGAGGTA -> GGTAGAGGTAA
GGTAGAGGTAA -> GTAGAGGTAAT
GTAGAGGTAAT -> TAGAGGTAATG
TAGAGGTAATG -> AGAGGTAATGA
AGAGGTAATGA -> GAGGTAATGAA
GAGGTAATGAA -> AGGTAATGAAC
AGGTAATGAAC -> GGTAATGAACG
GGTAATGAACG -> GTAATGAACGG
GTAATGAACGG -> TAATGAACGGA
TAATGAACGGA -> AATGAACGGAG
AATGAACGGAG -> ATGAACGGAGC
ATGAACGGAGC -> TGAACGGAGCC
TGAACGGAGCC -> GAACGGAGCCC
GAACGGAGCCC -> AACGGAGCCCC
AACGGAGCCCC -> ACGGAGCCCCC
ACGGAGCCCCC -> CGGAGCCCCCC
CGGAGCCCCCC -> GGAGCCCCCCC
GGAGCCCCCCC -> GAGCCCCCCCC
GAGCCCCCCCC -> AGCCCCCCCCG
AGCCCCCCCCG -> GCCCCCCCCGT
GCCCCCCCCGT -> CCCCCCCCGTA
CCCCCCCCGTA -> CCCCCCCGTAG
CCCCCCCGTAG -> CCCCCCGTAGT
CCCCCCGTAGT -> CCCCCGTAGTA
CCCCCGTAGTA -> CCCCGTAGTAT
CCCCGTAGTAT -> CCCGTAGTATC
CCCGTAGTATC -> CCGTAGTATCC
CCGTAGTATCC -> CGTAGTATCCC
CGTAGTATCCC -> GTAGTATCCCA
GTAGTATCCCA -> TAGTATCCCAT
TAGTATCCCAT -> AGTATCCCATA
AGTATCCCATA -> GTATCCCATAG
GTATCCCATAG -> TATCCCATAGA
TATCCCATAGA -> ATCCCATAGAC
ATCCCATAGAC -> TCCCATAGACA
TCCCATAGACA -> CCCATAGACAT
CCCATAGACAT -> CCATAGACATT
CCATAGACATT -> CATAGACATTG
CATAGACATTG -> ATAGACATTGT
ATAGACATTGT -> TAGACATTGTG
TAGACATTGTG -> AGACATTGTGA
AGACATTGTGA -> GACATTGTGAC
GACATTGTGAC -> ACATTGTGACC
ACATTGTGACC -> CATTGTGACCG
CATTGTGACCG -> ATTGTGACCGG
ATTGTGACCGG -> TTGTGACCGGG
TTGTGACCGGG -> TGTGACCGGGT
TGTGACCGGGT -> GTGACCGGGTG
GTGACCGGGTG -> TGACCGGGTGC
TGACCGGGTGC -> GACCGGGTGCT
GACCGGGTGCT -> ACCGGGTGCTA
ACCGGGTGCTA -> CCGGGTGCTAC
CCGGGTGCTAC -> CGGGTGCTACA
CGGGTGCTACA -> GGGTGCTACAG
GGGTGCTACAG -> GGTGCTACAGA
GGTGCTACAGA -> GTGCTACAGAA
GTGCTACAGAA -> TGCTACAGAAA
TGCTACAGAAA -> GCTACAGAAAG
GCTACAGAAAG -> CTACAGAAAGC
CTACAGAAAGC -> TACAGAAAGCG
TACAGAAAGCG -> ACAGAAAGCGT
ACAGAAAGCGT -> CAGAAAGCGTC
CAGAAAGCGTC -> AGAAAGCGTCA
AGAAAGCGTCA -> GAAAGCGTCAT
GAAAGCGTCAT -> AAAGCGTCATC
AAAGCGTCATC -> AAGCGTCATCG
AAGCGTCATCG -> AGCGTCATCGC
AGCGTCATCGC -> GCGTCATCGCG
GCGTCATCGCG -> CGTCATCGCGG
CGTCATCGCGG -> GTCATCGCGGC
GTCATCGCGGC -> TCATCGCGGCA
TCATCGCGGCA -> CATCGCGGCAG
CATCGCGGCAG -> ATCGCGGCAGT
ATCGCGGCAGT -> TCGCGGCAGTG
TCGCGGCAGTG -> CGCGGCAGTGC
CGCGGCAGTGC -> GCGGCAGTGCA
GCGGCAGTGCA -> CGGCAGTGCAA
CGGCAGTGCAA -> GGCAGTGCAAT
GGCAGTGCAAT -> GCAGTGCAATA
GCAGTGCAATA -> CAGTGCAATAC
CAGTGCAATAC -> AGTGCAATACC
AGTGCAATACC -> GTGCAATACCC
GTGCAATACCC -> TGCAATACCCC
TGCAATACCCC -> GCAATACCCCT
GCAATACCCCT -> CAATACCCCTA
CAATACCCCTA -> AATACCCCTAA
AATACCCCTAA -> ATACCCCTAAC
ATACCCCTAAC -> TACCCCTAACA
TACCCCTAACA -> ACCCCTAACAG
ACCCCTAACAG -> CCCCTAACAGA
CCCCTAACAGA -> CCCTAACAGAA
CCCTAACAGAA -> CCTAACAGAAC
CCTAACAGAAC -> CTAACAGAACT
CTAACAGAACT -> TAACAGAACTG
TAACAGAACTG -> AACAGAACTGC
AACAGAACTGC -> ACAGAACTGCA
ACAGAACTGCA -> CAGAACTGCAT
CAGAACTGCAT -> AGAACTGCATG
AGAACTGCATG -> GAACTGCATGT
GAACTGCATGT -> AACTGCATGTG
AACTGCATGTG -> ACTGCATGTGA
ACTGCATGTGA -> CTGCATGTGAT
CTGCATGTGAT -> TGCATGTGATA
TGCATGTGATA -> GCATGTGATAT
GCATGTGATAT -> CATGTGATATA
CATGTGATATA -> ATGTGATATAC
ATGTGATATAC -> TGTGATATACC
TGTGATATACC -> GTGATATACCG
GTGATATACCG -> TGATATACCGC
TGATATACCGC -> GATATACCGCT
GATATACCGCT -> ATATACCGCTG
ATATACCGCTG -> TATACCGCTGC
TATACCGCTGC -> ATACCGCTGCA
ATACCGCTGCA -> TACCGCTGCAG
TACCGCTGCAG -> ACCGCTGCAGC
ACCGCTGCAGC -> CCGCTGCAGCA
CCGCTGCAGCA -> CGCTGCAGCAG
CGCTGCAGCAG -> GCTGCAGCAGA
GCTGCAGCAGA -> CTGCAGCAGAG
CTGCAGCAGAG -> TGCAGCAGAGT
TGCAGCAGAGT -> GCAGCAGAGTC
GCAGCAGAGTC -> CAGCAGAGTCG
CAGCAGAGTCG -> AGCAGAGTCGA
AGCAGAGTCGA -> GCAGAGTCGAG
GCAGAGTCGAG -> CAGAGTCGAGT
CAGAGTCGAGT -> AGAGTCGAGTC
AGAGTCGAGTC -> GAGTCGAGTCG
GAGTCGAGTCG -> AGTCGAGTCGA
AGTCGAGTCGA -> GTCGAGTCGAT
GTCGAGTCGAT -> TCGAGTCGATA
TCGAGTCGATA -> CGAGTCGATAG
CGAGTCGATAG -> GAGTCGATAGC
GAGTCGATAGC -> AGTCGATAGCG
AGTCGATAGCG -> GTCGATAGCGG
GTCGATAGCGG -> TCGATAGCGGA
TCGATAGCGGA -> CGATAGCGGAT
CGATAGCGGAT -> GATAGCGGATT
GATAGCGGATT -> ATAGCGGATTT
ATAGCGGATTT -> TAGCGGATTTA
TAGCGGATTTA -> AGCGGATTTAG
AGCGGATTTAG -> GCGGATTTAGA
GCGGATTTAGA -> CGGATTTAGAG
CGGATTTAGAG -> GGATTTAGAGT
GGATTTAGAGT -> GATTTAGAGTT
GATTTAGAGTT -> ATTTAGAGTTT
ATTTAGAGTTT -> TTTAGAGTTTA
TTTAGAGTTTA -> TTAGAGTTTAA
TTAGAGTTTAA -> TAGAGTTTAAA
TAGAGTTTAAA -> AGAGTTTAAAG
AGAGTTTAAAG -> GAGTTTAAAGG
GAGTTTAAAGG -> AGTTTAAAGGG
AGTTTAAAGGG -> GTTTAAAGGGC
GTTTAAAGGGC -> TTTAAAGGGCG
TTTAAAGGGCG -> TTAAAGGGCGT
TTAAAGGGCGT -> TAAAGGGCGTA
TAAAGGGCGTA -> AAAGGGCGTAT
AAAGGGCGTAT -> AAGGGCGTATA
AAGGGCGTATA -> AGGGCGTATAA
AGGGCGTATAA -> GGGCGTATAAA
GGGCGTATAAA -> GGCGTATAAAC
GGCGTATAAAC -> GCGTATAAACT
GCGTATAAACT -> CGTATAAACTT
CGTATAAACTT -> GTATAAACTTT
GTATAAACTTT -> TATAAACTTTG
TATAAACTTTG -> ATAAACTTTGC
ATAAACTTTGC -> TAAACTTTGCA
TAAACTTTGCA -> AAACTTTGCAT
AAACTTTGCAT -> AACTTTGCATT
AACTTTGCATT -> ACTTTGCATTG
ACTTTGCATTG -> CTTTGCATTGG
CTTTGCATTGG -> TTTGCATTGGG
TTTGCATTGGG -> TTGCATTGGGT
TTGCATTGGGT -> TGCATTGGGTC
TGCATTGGGTC -> GCATTGGGTCG
GCATTGGGTCG -> CATTGGGTCGG
CATTGGGTCGG -> ATTGGGTCGGG
ATTGGGTCGGG -> TTGGGTCGGGA
TTGGGTCGGGA -> TGGGTCGGGAG
TGGGTCGGGAG -> GGGTCGGGAGT
GGGTCGGGAGT -> GGTCGGGAGTG
GGTCGGGAGTG -> GTCGGGAGTGG
GTCGGGAGTGG -> TCGGGAGTGGT
TCGGGAGTGGT -> CGGGAGTGGTG
CGGGAGTGGTG -> GGGAGTGGTGA
GGGAGTGGTGA -> GGAGTGGTGAT
GGAGTGGTGAT -> GAGTGGTGATC
GAGTGGTGATC -> AGTGGTGATCA
AGTGGTGATCA -> GTGGTGATCAT
GTGGTGATCAT -> TGGTGATCATC
TGGTGATCATC -> GGTGATCATCC
GGTGATCATCC -> GTGATCATCCG
GTGATCATCCG -> TGATCATCCGT
TGATCATCCGT -> GATCATCCGTA
GATCATCCGTA -> ATCATCCGTAC
ATCATCCGTAC -> TCATCCGTACT
TCATCCGTACT -> CATCCGTACTT
CATCCGTACTT -> ATCCGTACTTC
ATCCGTACTTC -> TCCGTACTTCC
TCCGTACTTCC -> CCGTACTTCCA
CCGTACTTCCA -> CGTACTTCCAT
CGTACTTCCAT -> GTACTTCCATA
GTACTTCCATA -> TACTTCCATAA
TACTTCCATAA -> ACTTCCATAAC
ACTTCCATAAC -> CTTCCATAACC
CTTCCATAACC -> TTCCATAACCC
TTCCATAACCC -> TCCATAACCCC
TCCATAACCCC -> CCATAACCCCC
CCATAACCCCC -> CATAACCCCCG
CATAACCCCCG -> ATAACCCCCGG
ATAACCCCCGG -> TAACCCCCGGA
TAACCCCCGGA -> AACCCCCGGAC
AACCCCCGGAC -> ACCCCCGGACC
ACCCCCGGACC -> CCCCCGGACCG
CCCCCGGACCG -> CCCCGGACCGC
CCCCGGACCGC -> CCCGGACCGCT
CCCGGACCGCT -> CCGGACCGCTT
CCGGACCGCTT -> CGGACCGCTTT
CGGACCGCTTT -> GGACCGCTTTT
GGACCGCTTTT -> GACCGCTTTTG
GACCGCTTTTG -> ACCGCTTTTGT
ACCGCTTTTGT -> CCGCTTTTGTA
CCGCTTTTGTA -> CGCTTTTGTAT
CGCTTTTGTAT -> GCTTTTGTATA
GCTTTTGTATA -> CTTTTGTATAA
CTTTTGTATAA -> TTTTGTATAAA
TTTTGTATAAA -> TTTGTATAAAT
TTTGTATAAAT -> TTGTATAAATC
TTGTATAAATC -> TGTATAAATCT
TGTATAAATCT -> GTATAAATCTC
GTATAAATCTC -> TATAAATCTCA
TATAAATCTCA -> ATAAATCTCAG
ATAAATCTCAG -> TAAATCTCAGG
TAAATCTCAGG -> AAATCTCAGGA
AAATCTCAGGA -> AATCTCAGGAC
AATCTCAGGAC -> ATCTCAGGACA
ATCTCAGGACA -> TCTCAGGACAG
TCTCAGGACAG -> CTCAGGACAGG
CTCAGGACAGG -> TCAGGACAGGG
TCAGGACAGGG -> CAGGACAGGGG
CAGGACAGGGG -> AGGACAGGGGC
AGGACAGGGGC -> GGACAGGGGCC
GGACAGGGGCC -> GACAGGGGCCC
GACAGGGGCCC -> ACAGGGGCCCT
ACAGGGGCCCT -> CAGGGGCCCTG
CAGGGGCCCTG -> AGGGGCCCTGT
AGGGGCCCTGT -> GGGGCCCTGTG
GGGGCCCTGTG -> GGGCCCTGTGA
GGGCCCTGTGA -> GGCCCTGTGAT
GGCCCTGTGAT -> GCCCTGTGATG
GCCCTGTGATG -> CCCTGTGATGC
CCCTGTGATGC -> CCTGTGATGCT
CCTGTGATGCT -> CTGTGATGCTT
CTGTGATGCTT -> TGTGATGCTTC
TGTGATGCTTC -> GTGATGCTTCG
GTGATGCTTCG -> TGATGCTTCGG
TGATGCTTCGG -> GATGCTTCGGA
GATGCTTCGGA -> ATGCTTCGGAG
ATGCTTCGGAG -> TGCTTCGGAGC
TGCTTCGGAGC -> GCTTCGGAGCC
GCTTCGGAGCC -> CTTCGGAGCCA
CTTCGGAGCCA -> TTCGGAGCCAT
TTCGGAGCCAT -> TCGGAGCCATG
TCGGAGCCATG -> CGGAGCCATGT
CGGAGCCATGT -> GGAGCCATGTG
GGAGCCATGTG -> GAGCCATGTGG
GAGCCATGTGG -> AGCCATGTGGA
AGCCATGTGGA -> GCCATGTGGAG
GCCATGTGGAG -> CCATGTGGAGC
CCATGTGGAGC -> CATGTGGAGCC
CATGTGGAGCC -> ATGTGGAGCCC
ATGTGGAGCCC -> TGTGGAGCCCA
TGTGGAGCCCA -> GTGGAGCCCAA
GTGGAGCCCAA -> TGGAGCCCAAT
TGGAGCCCAAT -> GGAGCCCAATA
GGAGCCCAATA -> GAGCCCAATAC
GAGCCCAATAC -> AGCCCAATACA
AGCCCAATACA -> GCCCAATACAG
GCCCAATACAG -> CCCAATACAGC
CCCAATACAGC -> CCAATACAGCG
CCAATACAGCG -> CAATACAGCGA
CAATACAGCGA -> AATACAGCGAG
AATACAGCGAG -> ATACAGCGAGA
ATACAGCGAGA -> TACAGCGAGAA
TACAGCGAGAA -> ACAGCGAGAAA
ACAGCGAGAAA -> CAGCGAGAAAT
CAGCGAGAAAT -> AGCGAGAAATG
AGCGAGAAATG -> GCGAGAAATGG
GCGAGAAATGG -> CGAGAAATGGT
CGAGAAATGGT -> GAGAAATGGTC
GAGAAATGGTC -> AGAAATGGTCT
AGAAATGGTCT -> GAAATGGTCTT
GAAATGGTCTT -> AAATGGTCTTC
AAATGGTCTTC -> AATGGTCTTCT
AATGGTCTTCT -> ATGGTCTTCTG
ATGGTCTTCTG -> TGGTCTTCTGA
TGGTCTTCTGA -> GGTCTTCTGAT
GGTCTTCTGAT -> GTCTTCTGATC
GTCTTCTGATC -> TCTTCTGATCT
TCTTCTGATCT -> CTTCTGATCTT
CTTCTGATCTT -> TTCTGATCTTC
TTCTGATCTTC -> TCTGATCTTCG
TCTGATCTTCG -> CTGATCTTCGT
CTGATCTTCGT -> TGATCTTCGTT
TGATCTTCGTT -> GATCTTCGTTA
GATCTTCGTTA -> ATCTTCGTTAT
ATCTTCGTTAT -> TCTTCGTTATT
TCTTCGTTATT -> CTTCGTTATTT
CTTCGTTATTT -> TTCGTTATTTA
TTCGTTATTTA -> TCGTTATTTAG
TCGTTATTTAG -> CGTTATTTAGG
CGTTATTTAGG -> GTTATTTAGGG
GTTATTTAGGG -> TTATTTAGGGA
TTATTTAGGGA -> TATTTAGGGAT
TATTTAGGGAT -> ATTTAGGGATG
ATTTAGGGATG -> TTTAGGGATGG
TTTAGGGATGG -> TTAGGGATGGT
TTAGGGATGGT -> TAGGGATGGTT
TAGGGATGGTT -> AGGGATGGTTC
AGGGATGGTTC -> GGGATGGTTCC
GGGATGGTTCC -> GGATGGTTCCC
GGATGGTTCCC -> GATGGTTCCCA
GATGGTTCCCA -> ATGGTTCCCAT
ATGGTTCCCAT -> TGGTTCCCATC
TGGTTCCCATC -> GGTTCCCATCA
GGTTCCCATCA -> GTTCCCATCAG
GTTCCCATCAG -> TTCCCATCAGA
TTCCCATCAGA -> TCCCATCAGAT
TCCCATCAGAT -> CCCATCAGATA
CCCATCAGATA -> CCATCAGATAT
CCATCAGATAT -> CATCAGATATC
CATCAGATATC -> ATCAGATATCG
ATCAGATATCG -> TCAGATATCGG
TCAGATATCGG -> CAGATATCGGA
CAGATATCGGA -> AGATATCGGAC
AGATATCGGAC -> GATATCGGACG
GATATCGGACG -> ATATCGGACGG
ATATCGGACGG -> TATCGGACGGT
TATCGGACGGT -> ATCGGACGGTT
ATCGGACGGTT -> TCGGACGGTTG
TCGGACGGTTG -> CGGACGGTTGT
CGGACGGTTGT -> GGACGGTTGTA
GGACGGTTGTA -> GACGGTTGTAC
GACGGTTGTAC -> ACGGTTGTACT
ACGGTTGTACT -> CGGTTGTACTT
CGGTTGTACTT -> GGTTGTACTTA
GGTTGTACTTA -> GTTGTACTTAG
GTTGTACTTAG -> TTGTACTTAGG
TTGTACTTAGG -> TGTACTTAGGT
TGTACTTAGGT -> GTACTTAGGTC
GTACTTAGGTC -> TACTTAGGTCC
TACTTAGGTCC -> ACTTAGGTCCA
ACTTAGGTCCA -> CTTAGGTCCAC
CTTAGGTCCAC -> TTAGGTCCACA
TTAGGTCCACA -> TAGGTCCACAA
TAGGTCCACAA -> AGGTCCACAAG
AGGTCCACAAG -> GGTCCACAAGC,GGTCCACAAGA
GGTCCACAAGC -> GTCCACAAGCT
GTCCACAAGCT -> TCCACAAGCTT
TCCACAAGCTT -> CCACAAGCTTA
CCACAAGCTTA -> CACAAGCTTAA
CACAAGCTTAA -> ACAAGCTTAAT
ACAAGCTTAAT -> CAAGCTTAATC
CAAGCTTAATC -> AAGCTTAATCA
AAGCTTAATCA -> AGCTTAATCAA
AGCTTAATCAA -> GCTTAATCAAG
GCTTAATCAAG -> CTTAATCAAGA
CTTAATCAAGA -> TTAATCAAGAT
TTAATCAAGAT -> TAATCAAGATA
TAATCAAGATA -> AATCAAGATAA
AATCAAGATAA -> ATCAAGATAAA
ATCAAGATAAA -> TCAAGATAAAT
TCAAGATAAAT -> CAAGATAAATC
CAAGATAAATC -> AAGATAAATCG
AAGATAAATCG -> AGATAAATCGG
AGATAAATCGG -> GATAAATCGGC
GATAAATCGGC -> ATAAATCGGCC
ATAAATCGGCC -> TAAATCGGCCC
TAAATCGGCCC -> AAATCGGCCCA
AAATCGGCCCA -> AATCGGCCCAG
AATCGGCCCAG -> ATCGGCCCAGC
ATCGGCCCAGC -> TCGGCCCAGCA
TCGGCCCAGCA -> CGGCCCAGCAT
CGGCCCAGCAT -> GGCCCAGCATC
GGCCCAGCATC -> GCCCAGCATCA
GCCCAGCATCA -> CCCAGCATCAA
CCCAGCATCAA -> CCAGCATCAAT
CCAGCATCAAT -> CAGCATCAATA
CAGCATCAATA -> AGCATCAATAG
AGCATCAATAG -> GCATCAATAGA
GCATCAATAGA -> CATCAATAGAC
CATCAATAGAC -> ATCAATAGACC
ATCAATAGACC -> TCAATAGACCG
TCAATAGACCG -> CAATAGACCGT
CAATAGACCGT -> AATAGACCGTG
AATAGACCGTG -> ATAGACCGTGA
ATAGACCGTGA -> TAGACCGTGAC
TAGACCGTGAC -> AGACCGTGACA
AGACCGTGACA -> GACCGTGACAG
GACCGTGACAG -> ACCGTGACAGA
ACCGTGACAGA -> CCGTGACAGAT
CCGTGACAGAT -> CGTGACAGATC
CGTGACAGATC -> GTGACAGATCG
GTGACAGATCG -> TGACAGATCGA
TGACAGATCGA -> GACAGATCGAG
GACAGATCGAG -> ACAGATCGAGT
ACAGATCGAGT -> CAGATCGAGTC
CAGATCGAGTC -> AGATCGAGTCG
AGATCGAGTCG -> GATCGAGTCGG
GATCGAGTCGG -> ATCGAGTCGGT
ATCGAGTCGGT -> TCGAGTCGGTC
TCGAGTCGGTC -> CGAGTCGGTCG
CGAGTCGGTCG -> GAGTCGGTCGT
GAGTCGGTCGT -> AGTCGGTCGTC
AGTCGGTCGTC -> GTCGGTCGTCC
GTCGGTCGTCC -> TCGGTCGTCCT
TCGGTCGTCCT -> CGGTCGTCCTT
CGGTCGTCCTT -> GGTCGTCCTTT
GGTCGTCCTTT -> GTCGTCCTTTC
GTCGTCCTTTC -> TCGTCCTTTCC
TCGTCCTTTCC -> CGTCCTTTCCA
CGTCCTTTCCA -> GTCCTTTCCAC
GTCCTTTCCAC -> TCCTTTCCACC
TCCTTTCCACC -> CCTTTCCACCT
CCTTTCCACCT -> CTTTCCACCTG
CTTTCCACCTG -> TTTCCACCTGC
TTTCCACCTGC -> TTCCACCTGCC
TTCCACCTGCC -> TCCACCTGCCA
TCCACCTGCCA -> CCACCTGCCAA
CCACCTGCCAA -> CACCTGCCAAA
CACCTGCCAAA -> ACCTGCCAAAG
ACCTGCCAAAG -> CCTGCCAAAGC
CCTGCCAAAGC -> CTGCCAAAGCC
CTGCCAAAGCC -> TGCCAAAGCCA
TGCCAAAGCCA -> GCCAAAGCCAA
GCCAAAGCCAA -> CCAAAGCCAAG
CCAAAGCCAAG -> CAAAGCCAAGT
CAAAGCCAAGT -> AAAGCCAAGTA
AAAGCCAAGTA -> AAGCCAAGTAT
AAGCCAAGTAT -> AGCCAAGTATC
AGCCAAGTATC -> GCCAAGTATCT
GCCAAGTATCT -> CCAAGTATCTG
CCAAGTATCTG -> CAAGTATCTGC
CAAGTATCTGC -> AAGTATCTGCA
AAGTATCTGCA -> AGTATCTGCAT
AGTATCTGCAT -> GTATCTGCATC
GTATCTGCATC -> TATCTGCATCG
TATCTGCATCG -> ATCTGCATCGA
ATCTGCATCGA -> TCTGCATCGAG
TCTGCATCGAG -> CTGCATCGAGC
CTGCATCGAGC -> TGCATCGAGCT
TGCATCGAGCT -> GCATCGAGCTA
GCATCGAGCTA -> CATCGAGCTAC
CATCGAGCTAC -> ATCGAGCTACT
ATCGAGCTACT -> TCGAGCTACTA
TCGAGCTACTA -> CGAGCTACTAT
CGAGCTACTAT -> GAGCTACTATC
GAGCTACTATC -> AGCTACTATCT
AGCTACTATCT -> GCTACTATCTG
GCTACTATCTG -> CTACTATCTGG
CTACTATCTGG -> TACTATCTGGT
TACTATCTGGT -> ACTATCTGGTA
ACTATCTGGTA -> CTATCTGGTAC
CTATCTGGTAC -> TATCTGGTACC
TATCTGGTACC -> ATCTGGTACCT
ATCTGGTACCT -> TCTGGTACCTA
TCTGGTACCTA -> CTGGTACCTAG
CTGGTACCTAG -> TGGTACCTAGT
TGGTACCTAGT -> GGTACCTAGTC
GGTACCTAGTC -> GTACCTAGTCT
GTACCTAGTCT -> TACCTAGTCTG
TACCTAGTCTG -> ACCTAGTCTGA
ACCTAGTCTGA -> CCTAGTCTGAA
CCTAGTCTGAA -> CTAGTCTGAAT
CTAGTCTGAAT -> TAGTCTGAATG
TAGTCTGAATG -> AGTCTGAATGT
AGTCTGAATGT -> GTCTGAATGTC
GTCTGAATGTC -> TCTGAATGTCG
TCTGAATGTCG -> CTGAATGTCGT
CTGAATGTCGT -> TGAATGTCGTC
TGAATGTCGTC -> GAATGTCGTCC
GAATGTCGTCC -> AATGTCGTCCG
AATGTCGTCCG -> ATGTCGTCCGC
ATGTCGTCCGC -> TGTCGTCCGCT
TGTCGTCCGCT -> GTCGTCCGCTG
GTCGTCCGCTG -> TCGTCCGCTGT
TCGTCCGCTGT -> CGTCCGCTGTG
CGTCCGCTGTG -> GTCCGCTGTGT
GTCCGCTGTGT -> TCCGCTGTGTA
TCCGCTGTGTA -> CCGCTGTGTAC
CCGCTGTGTAC -> CGCTGTGTACG
CGCTGTGTACG -> GCTGTGTACGT
GCTGTGTACGT -> CTGTGTACGTC
CTGTGTACGTC -> TGTGTACGTCA
TGTGTACGTCA -> GTGTACGTCAG
GTGTACGTCAG -> TGTACGTCAGT
TGTACGTCAGT -> GTACGTCAGTT
GTACGTCAGTT -> TACGTCAGTTG
TACGTCAGTTG -> ACGTCAGTTGT
ACGTCAGTTGT -> CGTCAGTTGTG
CGTCAGTTGTG -> GTCAGTTGTGC
GTCAGTTGTGC -> TCAGTTGTGCA
TCAGTTGTGCA -> CAGTTGTGCAC
CAGTTGTGCAC -> AGTTGTGCACT
AGTTGTGCACT -> GTTGTGCACTT
GTTGTGCACTT -> TTGTGCACTTC
TTGTGCACTTC -> TGTGCACTTCA
TGTGCACTTCA -> GTGCACTTCAC
GTGCACTTCAC -> TGCACTTCACC
TGCACTTCACC -> GCACTTCACCC
GCACTTCACCC -> CACTTCACCCC
CACTTCACCCC -> ACTTCACCCCG
ACTTCACCCCG -> CTTCACCCCGC
CTTCACCCCGC -> TTCACCCCGCT
TTCACCCCGCT -> TCACCCCGCTT
TCACCCCGCTT -> CACCCCGCTTC
CACCCCGCTTC -> ACCCCGCTTCT
ACCCCGCTTCT -> CCCCGCTTCTG
CCCCGCTTCTG -> CCCGCTTCTGT
CCCGCTTCTGT -> CCGCTTCTGTC
CCGCTTCTGTC -> CGCTTCTGTCC
CGCTTCTGTCC -> GCTTCTGTCCG
GCTTCTGTCCG -> CTTCTGTCCGA
CTTCTGTCCGA -> TTCTGTCCGAA
TTCTGTCCGAA -> TCTGTCCGAAC
TCTGTCCGAAC -> CTGTCCGAACG
CTGTCCGAACG -> TGTCCGAACGA
TGTCCGAACGA -> GTCCGAACGAA
GTCCGAACGAA -> TCCGAACGAAC
TCCGAACGAAC -> CCGAACGAACT
CCGAACGAACT -> CGAACGAACTC
CGAACGAACTC -> GAACGAACTCT
GAACGAACTCT -> AACGAACTCTA
AACGAACTCTA -> ACGAACTCTAT
ACGAACTCTAT -> CGAACTCTATG
CGAACTCTATG -> GAACTCTATGG
GAACTCTATGG -> AACTCTATGGA
AACTCTATGGA -> ACTCTATGGAT
ACTCTATGGAT -> CTCTATGGATG
CTCTATGGATG -> TCTATGGATGG
TCTATGGATGG -> CTATGGATGGG
CTATGGATGGG -> TATGGATGGGG
TATGGATGGGG -> ATGGATGGGGA
ATGGATGGGGA -> TGGATGGGGAA
TGGATGGGGAA -> GGATGGGGAAA
GGATGGGGAAA -> GATGGGGAAAC
GATGGGGAAAC -> ATGGGGAAACG
ATGGGGAAACG -> TGGGGAAACGC
TGGGGAAACGC -> GGGGAAACGCG
GGGGAAACGCG -> GGGAAACGCGG
GGGAAACGCGG -> GGAAACGCGGC
GGAAACGCGGC -> GAAACGCGGCA
GAAACGCGGCA -> AAACGCGGCAA
AAACGCGGCAA -> AACGCGGCAAG
AACGCGGCAAG -> ACGCGGCAAGG
ACGCGGCAAGG -> CGCGGCAAGGA
CGCGGCAAGGA -> GCGGCAAGGAT
GCGGCAAGGAT -> CGGCAAGGATA
CGGCAAGGATA -> GGCAAGGATAA
GGCAAGGATAA -> GCAAGGATAAT
GCAAGGATAAT -> CAAGGATAATA
CAAGGATAATA -> AAGGATAATAC
AAGGATAATAC -> AGGATAATACG
AGGATAATACG -> GGATAATACGC
GGATAATACGC -> GATAATACGCA
GATAATACGCA -> ATAATACGCAC
ATAATACGCAC -> TAATACGCACT
TAATACGCACT -> AATACGCACTT
AATACGCACTT -> ATACGCACTTA
ATACGCACTTA -> TACGCACTTAT
TACGCACTTAT -> ACGCACTTATT
ACGCACTTATT -> CGCACTTATTT
CGCACTTATTT -> GCACTTATTTA
GCACTTATTTA -> CACTTATTTAA
CACTTATTTAA -> ACTTATTTAAA
ACTTATTTAAA -> CTTATTTAAAC
CTTATTTAAAC -> TTATTTAAACA
TTATTTAAACA -> TATTTAAACAC
TATTTAAACAC -> ATTTAAACACC
ATTTAAACACC -> TTTAAACACCG
TTTAAACACCG -> TTAAACACCGC
TTAAACACCGC -> TAAACACCGCA
TAAACACCGCA -> AAACACCGCAT
AAACACCGCAT -> AACACCGCATT
AACACCGCATT -> ACACCGCATTC
ACACCGCATTC -> CACCGCATTCT
CACCGCATTCT -> ACCGCATTCTA
ACCGCATTCTA -> CCGCATTCTAT
CCGCATTCTAT -> CGCATTCTATT
CGCATTCTATT -> GCATTCTATTG
GCATTCTATTG -> CATTCTATTGT
CATTCTATTGT -> ATTCTATTGTT
ATTCTATTGTT -> TTCTATTGTTT
TTCTATTGTTT -> TCTATTGTTTT
TCTATTGTTTT -> CTATTGTTTTT
CTATTGTTTTT -> TATTGTTTTTT
TATTGTTTTTT -> ATTGTTTTTTA
ATTGTTTTTTA -> TTGTTTTTTAC
TTGTTTTTTAC -> TGTTTTTTACT
TGTTTTTTACT -> GTTTTTTACTA
GTTTTTTACTA -> TTTTTTACTAT
TTTTTTACTAT -> TTTTTACTATG
TTTTTACTATG -> TTTTACTATGT
TTTTACTATGT -> TTTACTATGTC
TTTACTATGTC -> TTACTATGTCG
TTACTATGTCG -> TACTATGTCGC
TACTATGTCGC -> ACTATGTCGCA
ACTATGTCGCA -> CTATGTCGCAA
CTATGTCGCAA -> TATGTCGCAAC
TATGTCGCAAC -> ATGTCGCAACG
ATGTCGCAACG -> TGTCGCAACGT
TGTCGCAACGT -> GTCGCAACGTG
GTCGCAACGTG -> TCGCAACGTGG
TCGCAACGTGG -> CGCAACGTGGG
CGCAACGTGGG -> GCAACGTGGGA
GCAACGTGGGA -> CAACGTGGGAT
CAACGTGGGAT -> AACGTGGGATA
AACGTGGGATA -> ACGTGGGATAG
ACGTGGGATAG -> CGTGGGATAGT
CGTGGGATAGT -> GTGGGATAGTC
GTGGGATAGTC -> TGGGATAGTCC
TGGGATAGTCC -> GGGATAGTCCG
GGGATAGTCCG -> GGATAGTCCGA
GGATAGTCCGA -> GATAGTCCGAC
GATAGTCCGAC -> ATAGTCCGACC
ATAGTCCGACC -> TAGTCCGACCG
TAGTCCGACCG -> AGTCCGACCGA
AGTCCGACCGA -> GTCCGACCGAC
GTCCGACCGAC -> TCCGACCGACG
TCCGACCGACG -> CCGACCGACGC
CCGACCGACGC -> CGACCGACGCT
CGACCGACGCT -> GACCGACGCTT
GACCGACGCTT -> ACCGACGCTTT
ACCGACGCTTT -> CCGACGCTTTG
CCGACGCTTTG -> CGACGCTTTGG
CGACGCTTTGG -> GACGCTTTGGT
GACGCTTTGGT -> ACGCTTTGGTT
ACGCTTTGGTT -> CGCTTTGGTTG
CGCTTTGGTTG -> GCTTTGGTTGT
GCTTTGGTTGT -> CTTTGGTTGTG
CTTTGGTTGTG -> TTTGGTTGTGG
TTTGGTTGTGG -> TTGGTTGTGGT
TTGGTTGTGGT -> TGGTTGTGGTC
TGGTTGTGGTC -> GGTTGTGGTCT
GGTTGTGGTCT -> GTTGTGGTCTG
GTTGTGGTCTG -> TTGTGGTCTGT
TTGTGGTCTGT -> TGTGGTCTGTG
TGTGGTCTGTG -> GTGGTCTGTGG
GTGGTCTGTGG -> TGGTCTGTGGG
TGGTCTGTGGG -> GGTCTGTGGGA
GGTCTGTGGGA -> GTCTGTGGGAT
GTCTGTGGGAT -> TCTGTGGGATA
TCTGTGGGATA -> CTGTGGGATAC
CTGTGGGATAC -> TGTGGGATACA
TGTGGGATACA -> GTGGGATACAC
GTGGGATACAC -> TGGGATACACT
TGGGATACACT -> GGGATACACTG
GGGATACACTG -> GGATACACTGT
GGATACACTGT -> GATACACTGTA
GATACACTGTA -> ATACACTGTAC
ATACACTGTAC -> TACACTGTACT
TACACTGTACT -> ACACTGTACTC
ACACTGTACTC -> CACTGTACTCC
CACTGTACTCC -> ACTGTACTCCG
ACTGTACTCCG -> CTGTACTCCGT
CTGTACTCCGT -> TGTACTCCGTT
TGTACTCCGTT -> GTACTCCGTTC
GTACTCCGTTC -> TACTCCGTTCT
TACTCCGTTCT -> ACTCCGTTCTC
ACTCCGTTCTC -> CTCCGTTCTCA
CTCCGTTCTCA -> TCCGTTCTCAG
TCCGTTCTCAG -> CCGTTCTCAGT
CCGTTCTCAGT -> CGTTCTCAGTG
CGTTCTCAGTG -> GTTCTCAGTGT
GTTCTCAGTGT -> TTCTCAGTGTA
TTCTCAGTGTA -> TCTCAGTGTAT
TCTCAGTGTAT -> CTCAGTGTATT
CTCAGTGTATT -> TCAGTGTATTA
TCAGTGTATTA -> CAGTGTATTAA
CAGTGTATTAA -> AGTGTATTAAG
AGTGTATTAAG -> GTGTATTAAGG
GTGTATTAAGG -> TGTATTAAGGC
TGTATTAAGGC -> GTATTAAGGCC
GTATTAAGGCC -> TATTAAGGCCC
TATTAAGGCCC -> ATTAAGGCCCA
ATTAAGGCCCA -> TTAAGGCCCAG
TTAAGGCCCAG -> TAAGGCCCAGC
TAAGGCCCAGC -> AAGGCCCAGCC
AAGGCCCAGCC -> AGGCCCAGCCA
AGGCCCAGCCA -> GGCCCAGCCAG
GGCCCAGCCAG -> GCCCAGCCAGA
GCCCAGCCAGA -> CCCAGCCAGAG
CCCAGCCAGAG -> CCAGCCAGAGC
CCAGCCAGAGC -> CAGCCAGAGCG
CAGCCAGAGCG -> AGCCAGAGCGC
AGCCAGAGCGC -> GCCAGAGCGCT
GCCAGAGCGCT -> CCAGAGCGCTG
CCAGAGCGCTG -> CAGAGCGCTGC
CAGAGCGCTGC -> AGAGCGCTGCT
AGAGCGCTGCT -> GAGCGCTGCTA
GAGCGCTGCTA -> AGCGCTGCTAT
AGCGCTGCTAT -> GCGCTGCTATG
GCGCTGCTATG -> CGCTGCTATGC
CGCTGCTATGC -> GCTGCTATGCC
GCTGCTATGCC -> CTGCTATGCCA
CTGCTATGCCA -> TGCTATGCCAG
TGCTATGCCAG -> GCTATGCCAGA
GCTATGCCAGA -> CTATGCCAGAA
CTATGCCAGAA -> TATGCCAGAAT
TATGCCAGAAT -> ATGCCAGAATA
ATGCCAGAATA -> TGCCAGAATAT
TGCCAGAATAT -> GCCAGAATATG
GCCAGAATATG -> CCAGAATATGG
CCAGAATATGG -> CAGAATATGGA
CAGAATATGGA -> AGAATATGGAG
AGAATATGGAG -> GAATATGGAGT
GAATATGGAGT -> AATATGGAGTG
AATATGGAGTG -> ATATGGAGTGG
ATATGGAGTGG -> TATGGAGTGGC
TATGGAGTGGC -> ATGGAGTGGCA
ATGGAGTGGCA -> TGGAGTGGCAG
TGGAGTGGCAG -> GGAGTGGCAGA
GGAGTGGCAGA -> GAGTGGCAGAG
GAGTGGCAGAG -> AGTGGCAGAGG
AGTGGCAGAGG -> GTGGCAGAGGG
GTGGCAGAGGG -> TGGCAGAGGGC
TGGCAGAGGGC -> GGCAGAGGGCA
GGCAGAGGGCA -> GCAGAGGGCAC
GCAGAGGGCAC -> CAGAGGGCACC
CAGAGGGCACC -> AGAGGGCACCC
AGAGGGCACCC -> GAGGGCACCCA
GAGGGCACCCA -> AGGGCACCCAT
AGGGCACCCAT -> GGGCACCCATC
GGGCACCCATC -> GGCACCCATCC
GGCACCCATCC -> GCACCCATCCG
GCACCCATCCG -> CACCCATCCGA
CACCCATCCGA -> ACCCATCCGAG
ACCCATCCGAG -> CCCATCCGAGG
CCCATCCGAGG -> CCATCCGAGGT
CCATCCGAGGT -> CATCCGAGGTC
CATCCGAGGTC -> ATCCGAGGTCG
ATCCGAGGTCG -> TCCGAGGTCGT
TCCGAGGTCGT -> CCGAGGTCGTC,CCGAGGTCGTG
CCGAGGTCGTC -> CGAGGTCGTCT
CGAGGTCGTCT -> GAGGTCGTCTA
GAGGTCGTCTA -> AGGTCGTCTAC
AGGTCGTCTAC -> GGTCGTCTACG
GGTCGTCTACG -> GTCGTCTACGC
GTCGTCTACGC -> TCGTCTACGCG
TCGTCTACGCG -> CGTCTACGCGG
CGTCTACGCGG -> GTCTACGCGGT
GTCTACGCGGT -> TCTACGCGGTT
TCTACGCGGTT -> CTACGCGGTTA
CTACGCGGTTA -> TACGCGGTTAA
TACGCGGTTAA -> ACGCGGTTAAT
ACGCGGTTAAT -> CGCGGTTAATA
CGCGGTTAATA -> GCGGTTAATAG
GCGGTTAATAG -> CGGTTAATAGA
CGGTTAATAGA -> GGTTAATAGAG
GGTTAATAGAG -> GTTAATAGAGA
GTTAATAGAGA -> TTAATAGAGAG
TTAATAGAGAG -> TAATAGAGAGC
TAATAGAGAGC -> AATAGAGAGCC
AATAGAGAGCC -> ATAGAGAGCCT
ATAGAGAGCCT -> TAGAGAGCCTG
TAGAGAGCCTG -> AGAGAGCCTGA
AGAGAGCCTGA -> GAGAGCCTGAC
GAGAGCCTGAC -> AGAGCCTGACA
AGAGCCTGACA -> GAGCCTGACAA
GAGCCTGACAA -> AGCCTGACAAA
AGCCTGACAAA -> GCCTGACAAAC
GCCTGACAAAC -> CCTGACAAACA
CCTGACAAACA -> CTGACAAACAG
CTGACAAACAG -> TGACAAACAGT
TGACAAACAGT -> GACAAACAGTC
GACAAACAGTC -> ACAAACAGTCG
ACAAACAGTCG -> CAAACAGTCGG
CAAACAGTCGG -> AAACAGTCGGA
AAACAGTCGGA -> AACAGTCGGAC
AACAGTCGGAC -> ACAGTCGGACT
ACAGTCGGACT -> CAGTCGGACTC
CAGTCGGACTC -> AGTCGGACTCC
AGTCGGACTCC -> GTCGGACTCCT
GTCGGACTCCT -> TCGGACTCCTG
TCGGACTCCTG -> CGGACTCCTGT
CGGACTCCTGT -> GGACTCCTGTG
GGACTCCTGTG -> GACTCCTGTGT
GACTCCTGTGT -> ACTCCTGTGTA
ACTCCTGTGTA -> CTCCTGTGTAA
CTCCTGTGTAA -> TCCTGTGTAAA
TCCTGTGTAAA -> CCTGTGTAAAT
CCTGTGTAAAT -> CTGTGTAAATA
CTGTGTAAATA -> TGTGTAAATAA
TGTGTAAATAA -> GTGTAAATAAA
GTGTAAATAAA -> TGTAAATAAAG
TGTAAATAAAG -> GTAAATAAAGC
GTAAATAAAGC -> TAAATAAAGCG
TAAATAAAGCG -> AAATAAAGCGC
AAATAAAGCGC -> AATAAAGCGCT
AATAAAGCGCT -> ATAAAGCGCTT
ATAAAGCGCTT -> TAAAGCGCTTA
TAAAGCGCTTA -> AAAGCGCTTAG
AAAGCGCTTAG -> AAGCGCTTAGG
AAGCGCTTAGG -> AGCGCTTAGGA
AGCGCTTAGGA -> GCGCTTAGGAA
GCGCTTAGGAA -> CGCTTAGGAAC
CGCTTAGGAAC -> GCTTAGGAACT
GCTTAGGAACT -> CTTAGGAACTT
CTTAGGAACTT -> TTAGGAACTTT
TTAGGAACTTT -> TAGGAACTTTT
TAGGAACTTTT -> AGGAACTTTTG
AGGAACTTTTG -> GGAACTTTTGG
GGAACTTTTGG -> GAACTTTTGGC
GAACTTTTGGC -> AACTTTTGGCC
AACTTTTGGCC -> ACTTTTGGCCT
ACTTTTGGCCT -> CTTTTGGCCTT
CTTTTGGCCTT -> TTTTGGCCTTC
TTTTGGCCTTC -> TTTGGCCTTCT
TTTGGCCTTCT -> TTGGCCTTCTA
TTGGCCTTCTA -> TGGCCTTCTAC
TGGCCTTCTAC -> GGCCTTCTACG
GGCCTTCTACG -> GCCTTCTACGT
GCCTTCTACGT -> CCTTCTACGTC
CCTTCTACGTC -> CTTCTACGTCG
CTTCTACGTCG -> TTCTACGTCGC
TTCTACGTCGC -> TCTACGTCGCT
TCTACGTCGCT -> CTACGTCGCTA
CTACGTCGCTA -> TACGTCGCTAG
TACGTCGCTAG -> ACGTCGCTAGG
ACGTCGCTAGG -> CGTCGCTAGGC
CGTCGCTAGGC -> GTCGCTAGGCC
GTCGCTAGGCC -> TCGCTAGGCCC
TCGCTAGGCCC -> CGCTAGGCCCT
CGCTAGGCCCT -> GCTAGGCCCTA
GCTAGGCCCTA -> CTAGGCCCTAC
CTAGGCCCTAC -> TAGGCCCTACT
TAGGCCCTACT -> AGGCCCTACTC
AGGCCCTACTC -> GGCCCTACTCG
GGCCCTACTCG -> GCCCTACTCGT
GCCCTACTCGT -> CCCTACTCGTC
CCCTACTCGTC -> CCTACTCGTCT
CCTACTCGTCT -> CTACTCGTCTA
CTACTCGTCTA -> TACTCGTCTAT
TACTCGTCTAT -> ACTCGTCTATC
ACTCGTCTATC -> CTCGTCTATCT
CTCGTCTATCT -> TCGTCTATCTA
TCGTCTATCTA -> CGTCTATCTAG
CGTCTATCTAG -> GTCTATCTAGG
GTCTATCTAGG -> TCTATCTAGGC
TCTATCTAGGC -> CTATCTAGGCG
CTATCTAGGCG -> TATCTAGGCGT
TATCTAGGCGT -> ATCTAGGCGTG
ATCTAGGCGTG -> TCTAGGCGTGT
TCTAGGCGTGT -> CTAGGCGTGTG
CTAGGCGTGTG -> TAGGCGTGTGT
TAGGCGTGTGT -> AGGCGTGTGTT
AGGCGTGTGTT -> GGCGTGTGTTG
GGCGTGTGTTG -> GCGTGTGTTGC
GCGTGTGTTGC -> CGTGTGTTGCT
CGTGTGTTGCT -> GTGTGTTGCTG
GTGTGTTGCTG -> TGTGTTGCTGA
TGTGTTGCTGA -> GTGTTGCTGAA
GTGTTGCTGAA -> TGTTGCTGAAT
TGTTGCTGAAT -> GTTGCTGAATC
GTTGCTGAATC -> TTGCTGAATCC
TTGCTGAATCC -> TGCTGAATCCA
TGCTGAATCCA -> GCTGAATCCAT
GCTGAATCCAT -> CTGAATCCATT
CTGAATCCATT -> TGAATCCATTC
TGAATCCATTC -> GAATCCATTCT
GAATCCATTCT -> AATCCATTCTA
AATCCATTCTA -> ATCCATTCTAG
ATCCATTCTAG -> TCCATTCTAGA
TCCATTCTAGA -> CCATTCTAGAA
CCATTCTAGAA -> CATTCTAGAAT
CATTCTAGAAT -> ATTCTAGAATG
ATTCTAGAATG -> TTCTAGAATGC
TTCTAGAATGC -> TCTAGAATGCC
TCTAGAATGCC -> CTAGAATGCCC
CTAGAATGCCC -> TAGAATGCCCT
TAGAATGCCCT -> AGAATGCCCTG
AGAATGCCCTG -> GAATGCCCTGT
GAATGCCCTGT -> AATGCCCTGTA
AATGCCCTGTA -> ATGCCCTGTAC
ATGCCCTGTAC -> TGCCCTGTACA
TGCCCTGTACA -> GCCCTGTACAG
GCCCTGTACAG -> CCCTGTACAGT
CCCTGTACAGT -> CCTGTACAGTC
CCTGTACAGTC -> CTGTACAGTCC
CTGTACAGTCC -> TGTACAGTCCC
TGTACAGTCCC -> GTACAGTCCCA
GTACAGTCCCA -> TACAGTCCCAC
TACAGTCCCAC -> ACAGTCCCACT
ACAGTCCCACT -> CAGTCCCACTG
CAGTCCCACTG -> AGTCCCACTGC
AGTCCCACTGC -> GTCCCACTGCA
GTCCCACTGCA -> TCCCACTGCAA
TCCCACTGCAA -> CCCACTGCAAG
CCCACTGCAAG -> CCACTGCAAGC
CCACTGCAAGC -> CACTGCAAGCT
CACTGCAAGCT -> ACTGCAAGCTA
ACTGCAAGCTA -> CTGCAAGCTAA
CTGCAAGCTAA -> TGCAAGCTAAT
TGCAAGCTAAT -> GCAAGCTAATC
GCAAGCTAATC -> CAAGCTAATCT
CAAGCTAATCT -> AAGCTAATCTC
AAGCTAATCTC -> AGCTAATCTCA
AGCTAATCTCA -> GCTAATCTCAA
GCTAATCTCAA -> CTAATCTCAAA
CTAATCTCAAA -> TAATCTCAAAT
TAATCTCAAAT -> AATCTCAAATA
AATCTCAAATA -> ATCTCAAATAG
ATCTCAAATAG -> TCTCAAATAGT
TCTCAAATAGT -> CTCAAATAGTT
CTCAAATAGTT -> TCAAATAGTTA
TCAAATAGTTA -> CAAATAGTTAC
CAAATAGTTAC -> AAATAGTTACA
AAATAGTTACA -> AATAGTTACAT
AATAGTTACAT -> ATAGTTACATC
ATAGTTACATC -> TAGTTACATCC
TAGTTACATCC -> AGTTACATCCT
AGTTACATCCT -> GTTACATCCTC
GTTACATCCTC -> TTACATCCTCT
TTACATCCTCT -> TACATCCTCTC
TACATCCTCTC -> ACATCCTCTCG
ACATCCTCTCG -> CATCCTCTCGT
CATCCTCTCGT -> ATCCTCTCGTG
ATCCTCTCGTG -> TCCTCTCGTGC
TCCTCTCGTGC -> CCTCTCGTGCA
CCTCTCGTGCA -> CTCTCGTGCAG
CTCTCGTGCAG -> TCTCGTGCAGT
TCTCGTGCAGT -> CTCGTGCAGTG
CTCGTGCAGTG -> TCGTGCAGTGG
TCGTGCAGTGG -> CGTGCAGTGGC
CGTGCAGTGGC -> GTGCAGTGGCA
GTGCAGTGGCA -> TGCAGTGGCAA
TGCAGTGGCAA -> GCAGTGGCAAT
GCAGTGGCAAT -> CAGTGGCAATT
CAGTGGCAATT -> AGTGGCAATTT
AGTGGCAATTT -> GTGGCAATTTC
GTGGCAATTTC -> TGGCAATTTCC
TGGCAATTTCC -> GGCAATTTCCT
GGCAATTTCCT -> GCAATTTCCTA
GCAATTTCCTA -> CAATTTCCTAC
CAATTTCCTAC -> AATTTCCTACC
AATTTCCTACC -> ATTTCCTACCT
ATTTCCTACCT -> TTTCCTACCTG
TTTCCTACCTG -> TTCCTACCTGA
TTCCTACCTGA -> TCCTACCTGAC
TCCTACCTGAC -> CCTACCTGACT
CCTACCTGACT -> CTACCTGACTG
CTACCTGACTG -> TACCTGACTGG
TACCTGACTGG -> ACCTGACTGGC
ACCTGACTGGC -> CCTGACTGGCA
CCTGACTGGCA -> CTGACTGGCAC
CTGACTGGCAC -> TGACTGGCACA
TGACTGGCACA -> GACTGGCACAA
GACTGGCACAA -> ACTGGCACAAG
ACTGGCACAAG -> CTGGCACAAGA
CTGGCACAAGA -> TGGCACAAGAA
TGGCACAAGAA -> GGCACAAGAAA
GGCACAAGAAA -> GCACAAGAAAA
GCACAAGAAAA -> CACAAGAAAAT
CACAAGAAAAT -> ACAAGAAAATC
ACAAGAAAATC -> CAAGAAAATCA
CAAGAAAATCA -> AAGAAAATCAG
AAGAAAATCAG -> AGAAAATCAGC
AGAAAATCAGC -> GAAAATCAGCT
GAAAATCAGCT -> AAAATCAGCTA
AAAATCAGCTA -> AAATCAGCTAG
AAATCAGCTAG -> AATCAGCTAGG
AATCAGCTAGG -> ATCAGCTAGGG
ATCAGCTAGGG -> TCAGCTAGGGC
TCAGCTAGGGC -> CAGCTAGGGCA
CAGCTAGGGCA -> AGCTAGGGCAA
AGCTAGGGCAA -> GCTAGGGCAAG
GCTAGGGCAAG -> CTAGGGCAAGT
CTAGGGCAAGT -> TAGGGCAAGTA
TAGGGCAAGTA -> AGGGCAAGTAC
AGGGCAAGTAC -> GGGCAAGTACC
GGGCAAGTACC -> GGCAAGTACCG
GGCAAGTACCG -> GCAAGTACCGT
GCAAGTACCGT -> CAAGTACCGTC
CAAGTACCGTC -> AAGTACCGTCG
AAGTACCGTCG -> AGTACCGTCGT
AGTACCGTCGT -> GTACCGTCGTG
GTACCGTCGTG -> TACCGTCGTGC
TACCGTCGTGC -> ACCGTCGTGCT
ACCGTCGTGCT -> CCGTCGTGCTT
CCGTCGTGCTT -> CGTCGTGCTTC
CGTCGTGCTTC -> GTCGTGCTTCT
GTCGTGCTTCT -> TCGTGCTTCTC
TCGTGCTTCTC -> CGTGCTTCTCG
CGTGCTTCTCG -> GTGCTTCTCGG
GTGCTTCTCGG -> TGCTTCTCGGC
TGCTTCTCGGC -> GCTTCTCGGCA
GCTTCTCGGCA -> CTTCTCGGCAT
CTTCTCGGCAT -> TTCTCGGCATC
TTCTCGGCATC -> TCTCGGCATCC
TCTCGGCATCC -> CTCGGCATCCA
CTCGGCATCCA -> TCGGCATCCAC
TCGGCATCCAC -> CGGCATCCACC
CGGCATCCACC -> GGCATCCACCT
GGCATCCACCT -> GCATCCACCTC
GCATCCACCTC -> CATCCACCTCA
CATCCACCTCA -> ATCCACCTCAA
ATCCACCTCAA -> TCCACCTCAAT
TCCACCTCAAT -> CCACCTCAATA
CCACCTCAATA -> CACCTCAATAG
CACCTCAATAG -> ACCTCAATAGG
ACCTCAATAGG -> CCTCAATAGGA
CCTCAATAGGA -> CTCAATAGGAA
CTCAATAGGAA -> TCAATAGGAAA
TCAATAGGAAA -> CAATAGGAAAA
CAATAGGAAAA -> AATAGGAAAAG
AATAGGAAAAG -> ATAGGAAAAGC
ATAGGAAAAGC -> TAGGAAAAGCG
TAGGAAAAGCG -> AGGAAAAGCGA
AGGAAAAGCGA -> GGAAAAGCGAC
GGAAAAGCGAC -> GAAAAGCGACA
GAAAAGCGACA -> AAAAGCGACAT
AAAAGCGACAT -> AAAGCGACATC
AAAGCGACATC -> AAGCGACATCC
AAGCGACATCC -> AGCGACATCCG
AGCGACATCCG -> GCGACATCCGT
GCGACATCCGT -> CGACATCCGTC
CGACATCCGTC -> GACATCCGTCC
GACATCCGTCC -> ACATCCGTCCT
ACATCCGTCCT -> CATCCGTCCTA
CATCCGTCCTA -> ATCCGTCCTAG
ATCCGTCCTAG -> TCCGTCCTAGC
TCCGTCCTAGC -> CCGTCCTAGCT
CCGTCCTAGCT -> CGTCCTAGCTG
CGTCCTAGCTG -> GTCCTAGCTGG
GTCCTAGCTGG -> TCCTAGCTGGG
TCCTAGCTGGG -> CCTAGCTGGGT
CCTAGCTGGGT -> CTAGCTGGGTT
CTAGCTGGGTT -> TAGCTGGGTTT
TAGCTGGGTTT -> AGCTGGGTTTT
AGCTGGGTTTT -> GCTGGGTTTTG
GCTGGGTTTTG -> CTGGGTTTTGC
CTGGGTTTTGC -> TGGGTTTTGCG
TGGGTTTTGCG -> GGGTTTTGCGG
GGGTTTTGCGG -> GGTTTTGCGGA
GGTTTTGCGGA -> GTTTTGCGGAG
GTTTTGCGGAG -> TTTTGCGGAGT
TTTTGCGGAGT -> TTTGCGGAGTA
TTTGCGGAGTA -> TTGCGGAGTAA
TTGCGGAGTAA -> TGCGGAGTAAT
TGCGGAGTAAT -> GCGGAGTAATA
GCGGAGTAATA -> CGGAGTAATAC
CGGAGTAATAC -> GGAGTAATACT
GGAGTAATACT -> GAGTAATACTC
GAGTAATACTC -> AGTAATACTCT
AGTAATACTCT -> GTAATACTCTC
GTAATACTCTC -> TAATACTCTCC
TAATACTCTCC -> AATACTCTCCG
AATACTCTCCG -> ATACTCTCCGA
ATACTCTCCGA -> TACTCTCCGAT
TACTCTCCGAT -> ACTCTCCGATC
ACTCTCCGATC -> CTCTCCGATCA
CTCTCCGATCA -> TCTCCGATCAT
TCTCCGATCAT -> CTCCGATCATT
CTCCGATCATT -> TCCGATCATTT
TCCGATCATTT -> CCGATCATTTG
CCGATCATTTG -> CGATCATTTGC
CGATCATTTGC -> GATCATTTGCG
GATCATTTGCG -> ATCATTTGCGC
ATCATTTGCGC -> TCATTTGCGCG
TCATTTGCGCG -> CATTTGCGCGT
CATTTGCGCGT -> ATTTGCGCGTG
ATTTGCGCGTG -> TTTGCGCGTGT
TTTGCGCGTGT -> TTGCGCGTGTT
TTGCGCGTGTT -> TGCGCGTGTTG
TGCGCGTGTTG -> GCGCGTGTTGG
GCGCGTGTTGG -> CGCGTGTTGGG
CGCGTGTTGGG -> GCGTGTTGGGT
GCGTGTTGGGT -> CGTGTTGGGTT
CGTGTTGGGTT -> GTGTTGGGTTC
GTGTTGGGTTC -> TGTTGGGTTCG
TGTTGGGTTCG -> GTTGGGTTCGG
GTTGGGTTCGG -> TTGGGTTCGGA
TTGGGTTCGGA -> TGGGTTCGGAG
TGGGTTCGGAG -> GGGTTCGGAGT
GGGTTCGGAGT -> GGTTCGGAGTA
GGTTCGGAGTA -> GTTCGGAGTAC
GTTCGGAGTAC -> TTCGGAGTACT
TTCGGAGTACT -> TCGGAGTACTC
TCGGAGTACTC -> CGGAGTACTCG
CGGAGTACTCG -> GGAGTACTCGT
GGAGTACTCGT -> GAGTACTCGTA
GAGTACTCGTA -> AGTACTCGTAG
AGTACTCGTAG -> GTACTCGTAGC
GTACTCGTAGC -> TACTCGTAGCA
TACTCGTAGCA -> ACTCGTAGCAG
ACTCGTAGCAG -> CTCGTAGCAGA
CTCGTAGCAGA -> TCGTAGCAGAG
TCGTAGCAGAG -> CGTAGCAGAGG
CGTAGCAGAGG -> GTAGCAGAGGT
GTAGCAGAGGT -> TAGCAGAGGTC
TAGCAGAGGTC -> AGCAGAGGTCT
AGCAGAGGTCT -> GCAGAGGTCTG
GCAGAGGTCTG -> CAGAGGTCTGT
CAGAGGTCTGT -> AGAGGTCTGTC
AGAGGTCTGTC -> GAGGTCTGTCG
GAGGTCTGTCG -> AGGTCTGTCGT
AGGTCTGTCGT -> GGTCTGTCGTT
GGTCTGTCGTT -> GTCTGTCGTTC
GTCTGTCGTTC -> TCTGTCGTTCA
TCTGTCGTTCA -> CTGTCGTTCAG
CTGTCGTTCAG -> TGTCGTTCAGT
TGTCGTTCAGT -> GTCGTTCAGTA
GTCGTTCAGTA -> TCGTTCAGTAT
TCGTTCAGTAT -> CGTTCAGTATG
CGTTCAGTATG -> GTTCAGTATGC
GTTCAGTATGC -> TTCAGTATGCA
TTCAGTATGCA -> TCAGTATGCAC
TCAGTATGCAC -> CAGTATGCACA
CAGTATGCACA -> AGTATGCACAG
AGTATGCACAG -> GTATGCACAGC
GTATGCACAGC -> TATGCACAGCC
TATGCACAGCC -> ATGCACAGCCC
ATGCACAGCCC -> TGCACAGCCCA
TGCACAGCCCA -> GCACAGCCCAA
GCACAGCCCAA -> CACAGCCCAAC
CACAGCCCAAC -> ACAGCCCAACT
ACAGCCCAACT -> CAGCCCAACTA
CAGCCCAACTA -> AGCCCAACTAC
AGCCCAACTAC -> GCCCAACTACG
GCCCAACTACG -> CCCAACTACGG
CCCAACTACGG -> CCAACTACGGG
CCAACTACGGG -> CAACTACGGGG
CAACTACGGGG -> AACTACGGGGC
AACTACGGGGC -> ACTACGGGGCT
ACTACGGGGCT -> CTACGGGGCTT
CTACGGGGCTT -> TACGGGGCTTA
TACGGGGCTTA -> ACGGGGCTTAT
ACGGGGCTTAT -> CGGGGCTTATA
CGGGGCTTATA -> GGGGCTTATAT
GGGGCTTATAT -> GGGCTTATATA
GGGCTTATATA -> GGCTTATATAA
GGCTTATATAA -> GCTTATATAAG
GCTTATATAAG -> CTTATATAAGC
CTTATATAAGC -> TTATATAAGCG
TTATATAAGCG -> TATATAAGCGT
TATATAAGCGT -> ATATAAGCGTG
ATATAAGCGTG -> TATAAGCGTGA
TATAAGCGTGA -> ATAAGCGTGAT
ATAAGCGTGAT -> TAAGCGTGATC
TAAGCGTGATC -> AAGCGTGATCC
AAGCGTGATCC -> AGCGTGATCCT
AGCGTGATCCT -> GCGTGATCCTC
GCGTGATCCTC -> CGTGATCCTCG
CGTGATCCTCG -> GTGATCCTCGT
GTGATCCTCGT -> TGATCCTCGTA
TGATCCTCGTA -> GATCCTCGTAC
GATCCTCGTAC -> ATCCTCGTACC
ATCCTCGTACC -> TCCTCGTACCC
TCCTCGTACCC -> CCTCGTACCCA
CCTCGTACCCA -> CTCGTACCCAT
CTCGTACCCAT -> TCGTACCCATG
TCGTACCCATG -> CGTACCCATGT
CGTACCCATGT -> GTACCCATGTC
GTACCCATGTC -> TACCCATGTCG
TACCCATGTCG -> ACCCATGTCGA
ACCCATGTCGA -> CCCATGTCGAG
CCCATGTCGAG -> CCATGTCGAGA
CCATGTCGAGA -> CATGTCGAGAA
CATGTCGAGAA -> ATGTCGAGAAT
ATGTCGAGAAT -> TGTCGAGAATA
TGTCGAGAATA -> GTCGAGAATAC
GTCGAGAATAC -> TCGAGAATACC
TCGAGAATACC -> CGAGAATACCG
CGAGAATACCG -> GAGAATACCGT
GAGAATACCGT -> AGAATACCGTT
AGAATACCGTT -> GAATACCGTTA
GAATACCGTTA -> AATACCGTTAA
AATACCGTTAA -> ATACCGTTAAG
ATACCGTTAAG -> TACCGTTAAGT
TACCGTTAAGT -> ACCGTTAAGTC
ACCGTTAAGTC -> CCGTTAAGTCA
CCGTTAAGTCA -> CGTTAAGTCAC
CGTTAAGTCAC -> GTTAAGTCACA
GTTAAGTCACA -> TTAAGTCACAT
TTAAGTCACAT -> TAAGTCACATC
TAAGTCACATC -> AAGTCACATCT
AAGTCACATCT -> AGTCACATCTC
AGTCACATCTC -> GTCACATCTCA
GTCACATCTCA -> TCACATCTCAG
TCACATCTCAG -> CACATCTCAGC
CACATCTCAGC -> ACATCTCAGCG
ACATCTCAGCG -> CATCTCAGCGG
CATCTCAGCGG -> ATCTCAGCGGG
ATCTCAGCGGG -> TCTCAGCGGGG
TCTCAGCGGGG -> CTCAGCGGGGC
CTCAGCGGGGC -> TCAGCGGGGCC
TCAGCGGGGCC -> CAGCGGGGCCA
CAGCGGGGCCA -> AGCGGGGCCAA
AGCGGGGCCAA -> GCGGGGCCAAG
GCGGGGCCAAG -> CGGGGCCAAGA
CGGGGCCAAGA -> GGGGCCAAGAT
GGGGCCAAGAT -> GGGCCAAGATA
GGGCCAAGATA -> GGCCAAGATAG
GGCCAAGATAG -> GCCAAGATAGC
GCCAAGATAGC -> CCAAGATAGCT
CCAAGATAGCT -> CAAGATAGCTC
CAAGATAGCTC -> AAGATAGCTCC
AAGATAGCTCC -> AGATAGCTCCG
AGATAGCTCCG -> GATAGCTCCGG
GATAGCTCCGG -> ATAGCTCCGGA
ATAGCTCCGGA -> TAGCTCCGGAC
TAGCTCCGGAC -> AGCTCCGGACT
AGCTCCGGACT -> GCTCCGGACTA
GCTCCGGACTA -> CTCCGGACTAA
CTCCGGACTAA -> TCCGGACTAAA
TCCGGACTAAA -> CCGGACTAAAT
CCGGACTAAAT -> CGGACTAAATA
CGGACTAAATA -> GGACTAAATAT
GGACTAAATAT -> GACTAAATATT
GACTAAATATT -> ACTAAATATTA
ACTAAATATTA -> CTAAATATTAA
CTAAATATTAA -> TAAATATTAAG
TAAATATTAAG -> AAATATTAAGC
AAATATTAAGC -> AATATTAAGCC
AATATTAAGCC -> ATATTAAGCCT
ATATTAAGCCT -> TATTAAGCCTA
TATTAAGCCTA -> ATTAAGCCTAT
ATTAAGCCTAT -> TTAAGCCTATC
TTAAGCCTATC -> TAAGCCTATCG
TAAGCCTATCG -> AAGCCTATCGC
AAGCCTATCGC -> AGCCTATCGCT
AGCCTATCGCT -> GCCTATCGCTA
GCCTATCGCTA -> CCTATCGCTAT
CCTATCGCTAT -> CTATCGCTATC
CTATCGCTATC -> TATCGCTATCA
TATCGCTATCA -> ATCGCTATCAA
ATCGCTATCAA -> TCGCTATCAAC
TCGCTATCAAC -> CGCTATCAACT
CGCTATCAACT -> GCTATCAACTC
GCTATCAACTC -> CTATCAACTCA
CTATCAACTCA -> TATCAACTCAG
TATCAACTCAG -> ATCAACTCAGT
ATCAACTCAGT -> TCAACTCAGTT
TCAACTCAGTT -> CAACTCAGTTA
CAACTCAGTTA -> AACTCAGTTAA
AACTCAGTTAA -> ACTCAGTTAAA
ACTCAGTTAAA -> CTCAGTTAAAT
CTCAGTTAAAT -> TCAGTTAAATA
TCAGTTAAATA -> CAGTTAAATAC
CAGTTAAATAC -> AGTTAAATACT
AGTTAAATACT -> GTTAAATACTC
GTTAAATACTC -> TTAAATACTCC
TTAAATACTCC -> TAAATACTCCG
TAAATACTCCG -> AAATACTCCGC
AAATACTCCGC -> AATACTCCGCT
AATACTCCGCT -> ATACTCCGCTT
ATACTCCGCTT -> TACTCCGCTTT
TACTCCGCTTT -> ACTCCGCTTTT
ACTCCGCTTTT -> CTCCGCTTTTC
CTCCGCTTTTC -> TCCGCTTTTCC
TCCGCTTTTCC -> CCGCTTTTCCT
CCGCTTTTCCT -> CGCTTTTCCTG
CGCTTTTCCTG -> GCTTTTCCTGC
GCTTTTCCTGC -> CTTTTCCTGCG
CTTTTCCTGCG -> TTTTCCTGCGA
TTTTCCTGCGA -> TTTCCTGCGAC
TTTCCTGCGAC -> TTCCTGCGACC
TTCCTGCGACC -> TCCTGCGACCT
TCCTGCGACCT -> CCTGCGACCTG
CCTGCGACCTG -> CTGCGACCTGT
CTGCGACCTGT -> TGCGACCTGTG
TGCGACCTGTG -> GCGACCTGTGC
GCGACCTGTGC -> CGACCTGTGCA
CGACCTGTGCA -> GACCTGTGCAA
GACCTGTGCAA -> ACCTGTGCAAC
ACCTGTGCAAC -> CCTGTGCAACG
CCTGTGCAACG -> CTGTGCAACGG
CTGTGCAACGG -> TGTGCAACGGT
TGTGCAACGGT -> GTGCAACGGTC
GTGCAACGGTC -> TGCAACGGTCG
TGCAACGGTCG -> GCAACGGTCGG
GCAACGGTCGG -> CAACGGTCGGG
CAACGGTCGGG -> AACGGTCGGGC
AACGGTCGGGC -> ACGGTCGGGCC
ACGGTCGGGCC -> CGGTCGGGCCT
CGGTCGGGCCT -> GGTCGGGCCTC
GGTCGGGCCTC -> GTCGGGCCTCT
GTCGGGCCTCT -> TCGGGCCTCTT
TCGGGCCTCTT -> CGGGCCTCTTG
CGGGCCTCTTG -> GGGCCTCTTGA
GGGCCTCTTGA -> GGCCTCTTGAT
GGCCTCTTGAT -> GCCTCTTGATG
GCCTCTTGATG -> CCTCTTGATGG
CCTCTTGATGG -> CTCTTGATGGC
CTCTTGATGGC -> TCTTGATGGCC
TCTTGATGGCC -> CTTGATGGCCG
CTTGATGGCCG -> TTGATGGCCGT
TTGATGGCCGT -> TGATGGCCGTC
TGATGGCCGTC -> GATGGCCGTCT
GATGGCCGTCT -> ATGGCCGTCTT
ATGGCCGTCTT -> TGGCCGTCTTC
TGGCCGTCTTC -> GGCCGTCTTCC
GGCCGTCTTCC -> GCCGTCTTCCG
GCCGTCTTCCG -> CCGTCTTCCGC
CCGTCTTCCGC -> CGTCTTCCGCC
CGTCTTCCGCC -> GTCTTCCGCCC
GTCTTCCGCCC -> TCTTCCGCCCG
TCTTCCGCCCG -> CTTCCGCCCGC
CTTCCGCCCGC -> TTCCGCCCGCG
TTCCGCCCGCG -> TCCGCCCGCGC
TCCGCCCGCGC -> CCGCCCGCGCT
CCGCCCGCGCT -> CGCCCGCGCTA
CGCCCGCGCTA -> GCCCGCGCTAA
GCCCGCGCTAA -> CCCGCGCTAAG
CCCGCGCTAAG -> CCGCGCTAAGC
CCGCGCTAAGC -> CGCGCTAAGCA
CGCGCTAAGCA -> GCGCTAAGCAA
GCGCTAAGCAA -> CGCTAAGCAAC
CGCTAAGCAAC -> GCTAAGCAACT
GCTAAGCAACT -> CTAAGCAACTT
CTAAGCAACTT -> TAAGCAACTTC
TAAGCAACTTC -> AAGCAACTTCA
AAGCAACTTCA -> AGCAACTTCAC
AGCAACTTCAC -> GCAACTTCACT
GCAACTTCACT -> CAACTTCACTT
CAACTTCACTT -> AACTTCACTTT
AACTTCACTTT -> ACTTCACTTTG
ACTTCACTTTG -> CTTCACTTTGC
CTTCACTTTGC -> TTCACTTTGCG
TTCACTTTGCG -> TCACTTTGCGA
TCACTTTGCGA -> CACTTTGCGAG
CACTTTGCGAG -> ACTTTGCGAGT
ACTTTGCGAGT -> CTTTGCGAGTT
CTTTGCGAGTT -> TTTGCGAGTTT
TTTGCGAGTTT -> TTGCGAGTTTA
TTGCGAGTTTA -> TGCGAGTTTAG
TGCGAGTTTAG -> GCGAGTTTAGT
GCGAGTTTAGT -> CGAGTTTAGTG
CGAGTTTAGTG -> GAGTTTAGTGA
GAGTTTAGTGA -> AGTTTAGTGAG
AGTTTAGTGAG -> GTTTAGTGAGA
GTTTAGTGAGA -> TTTAGTGAGAG
TTTAGTGAGAG -> TTAGTGAGAGT
TTAGTGAGAGT -> TAGTGAGAGTG
TAGTGAGAGTG -> AGTGAGAGTGC
AGTGAGAGTGC -> GTGAGAGTGCA
GTGAGAGTGCA -> TGAGAGTGCAG
TGAGAGTGCAG -> GAGAGTGCAGG
GAGAGTGCAGG -> AGAGTGCAGGA
AGAGTGCAGGA -> GAGTGCAGGAG
GAGTGCAGGAG -> AGTGCAGGAGA
AGTGCAGGAGA -> GTGCAGGAGAG
GTGCAGGAGAG -> TGCAGGAGAGC
TGCAGGAGAGC -> GCAGGAGAGCT
GCAGGAGAGCT -> CAGGAGAGCTA
CAGGAGAGCTA -> AGGAGAGCTAT
AGGAGAGCTAT -> GGAGAGCTATC
GGAGAGCTATC -> GAGAGCTATCA
GAGAGCTATCA -> AGAGCTATCAG
AGAGCTATCAG -> GAGCTATCAGG
GAGCTATCAGG -> AGCTATCAGGT
AGCTATCAGGT -> GCTATCAGGTA
GCTATCAGGTA -> CTATCAGGTAG
CTATCAGGTAG -> TATCAGGTAGT
TATCAGGTAGT -> ATCAGGTAGTA
ATCAGGTAGTA -> TCAGGTAGTAT
TCAGGTAGTAT -> CAGGTAGTATC
CAGGTAGTATC -> AGGTAGTATCA
AGGTAGTATCA -> GGTAGTATCAG
GGTAGTATCAG -> GTAGTATCAGC
GTAGTATCAGC -> TAGTATCAGCC
TAGTATCAGCC -> AGTATCAGCCC
AGTATCAGCCC -> GTATCAGCCCA
GTATCAGCCCA -> TATCAGCCCAT
TATCAGCCCAT -> ATCAGCCCATT
ATCAGCCCATT -> TCAGCCCATTG
TCAGCCCATTG -> CAGCCCATTGA
CAGCCCATTGA -> AGCCCATTGAC
AGCCCATTGAC -> GCCCATTGACG
GCCCATTGACG -> CCCATTGACGG
CCCATTGACGG -> CCATTGACGGA
CCATTGACGGA -> CATTGACGGAT
CATTGACGGAT -> ATTGACGGATT
ATTGACGGATT -> TTGACGGATTT
TTGACGGATTT -> TGACGGATTTA
TGACGGATTTA -> GACGGATTTAC
GACGGATTTAC -> ACGGATTTACC
ACGGATTTACC -> CGGATTTACCT
CGGATTTACCT -> GGATTTACCTG
GGATTTACCTG -> GATTTACCTGA
GATTTACCTGA -> ATTTACCTGAG
ATTTACCTGAG -> TTTACCTGAGA
TTTACCTGAGA -> TTACCTGAGAT
TTACCTGAGAT -> TACCTGAGATA
TACCTGAGATA -> ACCTGAGATAA
ACCTGAGATAA -> CCTGAGATAAA
CCTGAGATAAA -> CTGAGATAAAG
CTGAGATAAAG -> TGAGATAAAGT
TGAGATAAAGT -> GAGATAAAGTT
GAGATAAAGTT -> AGATAAAGTTG
AGATAAAGTTG -> GATAAAGTTGT
GATAAAGTTGT -> ATAAAGTTGTT
ATAAAGTTGTT -> TAAAGTTGTTG
TAAAGTTGTTG -> AAAGTTGTTGC
AAAGTTGTTGC -> AAGTTGTTGCG
AAGTTGTTGCG -> AGTTGTTGCGG
AGTTGTTGCGG -> GTTGTTGCGGG
GTTGTTGCGGG -> TTGTTGCGGGC
TTGTTGCGGGC -> TGTTGCGGGCC
TGTTGCGGGCC -> GTTGCGGGCCT
GTTGCGGGCCT -> TTGCGGGCCTT
TTGCGGGCCTT -> TGCGGGCCTTC
TGCGGGCCTTC -> GCGGGCCTTCG
GCGGGCCTTCG -> CGGGCCTTCGT
CGGGCCTTCGT -> GGGCCTTCGTA
GGGCCTTCGTA -> GGCCTTCGTAT
GGCCTTCGTAT -> GCCTTCGTATG
GCCTTCGTATG -> CCTTCGTATGT
CCTTCGTATGT -> CTTCGTATGTC
CTTCGTATGTC -> TTCGTATGTCC
TTCGTATGTCC -> TCGTATGTCCA
TCGTATGTCCA -> CGTATGTCCAG
CGTATGTCCAG -> GTATGTCCAGG
GTATGTCCAGG -> TATGTCCAGGT
TATGTCCAGGT -> ATGTCCAGGTC
ATGTCCAGGTC -> TGTCCAGGTCC
TGTCCAGGTCC -> GTCCAGGTCCA
GTCCAGGTCCA -> TCCAGGTCCAC
TCCAGGTCCAC -> CCAGGTCCACA
CCAGGTCCACA -> CAGGTCCACAA
CAGGTCCACAA -> AGGTCCACAAG
GGTCCACAAGA -> GTCCACAAGAC
GTCCACAAGAC -> TCCACAAGACG
TCCACAAGACG -> CCACAAGACGA
CCACAAGACGA -> CACAAGACGAG
CACAAGACGAG -> ACAAGACGAGT
ACAAGACGAGT -> CAAGACGAGTA
CAAGACGAGTA -> AAGACGAGTAC
AAGACGAGTAC -> AGACGAGTACA
AGACGAGTACA -> GACGAGTACAT
GACGAGTACAT -> ACGAGTACATA
ACGAGTACATA -> CGAGTACATAC
CGAGTACATAC -> GAGTACATACC
GAGTACATACC -> AGTACATACCA
AGTACATACCA -> GTACATACCAG
GTACATACCAG -> TACATACCAGG
TACATACCAGG -> ACATACCAGGA
ACATACCAGGA -> CATACCAGGAC
CATACCAGGAC -> ATACCAGGACT
ATACCAGGACT -> TACCAGGACTA
TACCAGGACTA -> ACCAGGACTAA
ACCAGGACTAA -> CCAGGACTAAA
CCAGGACTAAA -> CAGGACTAAAT
CAGGACTAAAT -> AGGACTAAATG
AGGACTAAATG -> GGACTAAATGC
GGACTAAATGC -> GACTAAATGCC
GACTAAATGCC -> ACTAAATGCCT
ACTAAATGCCT -> CTAAATGCCTT
CTAAATGCCTT -> TAAATGCCTTT
TAAATGCCTTT -> AAATGCCTTTG
AAATGCCTTTG -> AATGCCTTTGA
AATGCCTTTGA -> ATGCCTTTGAT
ATGCCTTTGAT -> TGCCTTTGATT
TGCCTTTGATT -> GCCTTTGATTT
GCCTTTGATTT -> CCTTTGATTTA
CCTTTGATTTA -> CTTTGATTTAT
CTTTGATTTAT -> TTTGATTTATC
TTTGATTTATC -> TTGATTTATCC
TTGATTTATCC -> TGATTTATCCG
TGATTTATCCG -> GATTTATCCGA
GATTTATCCGA -> ATTTATCCGAT
ATTTATCCGAT -> TTTATCCGATG
TTTATCCGATG -> TTATCCGATGT
TTATCCGATGT -> TATCCGATGTA
TATCCGATGTA -> ATCCGATGTAC
ATCCGATGTAC -> TCCGATGTACT
TCCGATGTACT -> CCGATGTACTA
CCGATGTACTA -> CGATGTACTAT
CGATGTACTAT -> GATGTACTATT
GATGTACTATT -> ATGTACTATTC
ATGTACTATTC -> TGTACTATTCG
TGTACTATTCG -> GTACTATTCGG
GTACTATTCGG -> TACTATTCGGG
TACTATTCGGG -> ACTATTCGGGT
ACTATTCGGGT -> CTATTCGGGTA
CTATTCGGGTA -> TATTCGGGTAA
TATTCGGGTAA -> ATTCGGGTAAT
ATTCGGGTAAT -> TTCGGGTAATA
TTCGGGTAATA -> TCGGGTAATAG
TCGGGTAATAG -> CGGGTAATAGT
CGGGTAATAGT -> GGGTAATAGTG
GGGTAATAGTG -> GGTAATAGTGG
GGTAATAGTGG -> GTAATAGTGGT
GTAATAGTGGT -> TAATAGTGGTC
TAATAGTGGTC -> AATAGTGGTCT
AATAGTGGTCT -> ATAGTGGTCTG
ATAGTGGTCTG -> TAGTGGTCTGG
TAGTGGTCTGG -> AGTGGTCTGGG
AGTGGTCTGGG -> GTGGTCTGGGA
GTGGTCTGGGA -> TGGTCTGGGAA
TGGTCTGGGAA -> GGTCTGGGAAA
GGTCTGGGAAA -> GTCTGGGAAAC
GTCTGGGAAAC -> TCTGGGAAACT
TCTGGGAAACT -> CTGGGAAACTC
CTGGGAAACTC -> TGGGAAACTCC
TGGGAAACTCC -> GGGAAACTCCC
GGGAAACTCCC -> GGAAACTCCCA
GGAAACTCCCA -> GAAACTCCCAC
GAAACTCCCAC -> AAACTCCCACT
AAACTCCCACT -> AACTCCCACTC
AACTCCCACTC -> ACTCCCACTCA
ACTCCCACTCA -> CTCCCACTCAA
CTCCCACTCAA -> TCCCACTCAAT
TCCCACTCAAT -> CCCACTCAATT
CCCACTCAATT -> CCACTCAATTT
CCACTCAATTT -> CACTCAATTTG
CACTCAATTTG -> ACTCAATTTGG
ACTCAATTTGG -> CTCAATTTGGC
CTCAATTTGGC -> TCAATTTGGCT
TCAATTTGGCT -> CAATTTGGCTG
CAATTTGGCTG -> AATTTGGCTGT
AATTTGGCTGT -> ATTTGGCTGTC
ATTTGGCTGTC -> TTTGGCTGTCC
TTTGGCTGTCC -> TTGGCTGTCCT
TTGGCTGTCCT -> TGGCTGTCCTG
TGGCTGTCCTG -> GGCTGTCCTGT
GGCTGTCCTGT -> GCTGTCCTGTG
GCTGTCCTGTG -> CTGTCCTGTGA
CTGTCCTGTGA -> TGTCCTGTGAT
TGTCCTGTGAT -> GTCCTGTGATT
GTCCTGTGATT -> TCCTGTGATTA
TCCTGTGATTA -> CCTGTGATTAC
CCTGTGATTAC -> CTGTGATTACT
CTGTGATTACT -> TGTGATTACTG
TGTGATTACTG -> GTGATTACTGC
GTGATTACTGC -> TGATTACTGCG
TGATTACTGCG -> GATTACTGCGG
GATTACTGCGG -> ATTACTGCGGT
ATTACTGCGGT -> TTACTGCGGTA
TTACTGCGGTA -> TACTGCGGTAG
TACTGCGGTAG -> ACTGCGGTAGA
ACTGCGGTAGA -> CTGCGGTAGAT
CTGCGGTAGAT -> TGCGGTAGATG
TGCGGTAGATG -> GCGGTAGATGC
GCGGTAGATGC -> CGGTAGATGCC
CGGTAGATGCC -> GGTAGATGCCT
GGTAGATGCCT -> GTAGATGCCTC
GTAGATGCCTC -> TAGATGCCTCG
TAGATGCCTCG -> AGATGCCTCGA
AGATGCCTCGA -> GATGCCTCGAT
GATGCCTCGAT -> ATGCCTCGATA
ATGCCTCGATA -> TGCCTCGATAC
TGCCTCGATAC -> GCCTCGATACA
GCCTCGATACA -> CCTCGATACAT
CCTCGATACAT -> CTCGATACATA
CTCGATACATA -> TCGATACATAA
TCGATACATAA -> CGATACATAAA
CGATACATAAA -> GATACATAAAT
GATACATAAAT -> ATACATAAATG
ATACATAAATG -> TACATAAATGT
TACATAAATGT -> ACATAAATGTG
ACATAAATGTG -> CATAAATGTGC
CATAAATGTGC -> ATAAATGTGCG
ATAAATGTGCG -> TAAATGTGCGT
TAAATGTGCGT -> AAATGTGCGTG
AAATGTGCGTG -> AATGTGCGTGT
AATGTGCGTGT -> ATGTGCGTGTA
ATGTGCGTGTA -> TGTGCGTGTAT
TGTGCGTGTAT -> GTGCGTGTATA
GTGCGTGTATA -> TGCGTGTATAT
TGCGTGTATAT -> GCGTGTATATG
GCGTGTATATG -> CGTGTATATGT
CGTGTATATGT -> GTGTATATGTT
GTGTATATGTT -> TGTATATGTTC
TGTATATGTTC -> GTATATGTTCA
GTATATGTTCA -> TATATGTTCAC
TATATGTTCAC -> ATATGTTCACA
ATATGTTCACA -> TATGTTCACAC
TATGTTCACAC -> ATGTTCACACT
ATGTTCACACT -> TGTTCACACTT
TGTTCACACTT -> GTTCACACTTC
GTTCACACTTC -> TTCACACTTCA
TTCACACTTCA -> TCACACTTCAC
TCACACTTCAC -> CACACTTCACT
CACACTTCACT -> ACACTTCACTG
ACACTTCACTG -> CACTTCACTGA
CACTTCACTGA -> ACTTCACTGAC
ACTTCACTGAC -> CTTCACTGACG
CTTCACTGACG -> TTCACTGACGC
TTCACTGACGC -> TCACTGACGCA
TCACTGACGCA -> CACTGACGCAC
CACTGACGCAC -> ACTGACGCACA
ACTGACGCACA -> CTGACGCACAC
CTGACGCACAC -> TGACGCACACT
TGACGCACACT -> GACGCACACTG
GACGCACACTG -> ACGCACACTGG
ACGCACACTGG -> CGCACACTGGG
CGCACACTGGG -> GCACACTGGGA
GCACACTGGGA -> CACACTGGGAT
CACACTGGGAT -> ACACTGGGATG
ACACTGGGATG -> CACTGGGATGC
CACTGGGATGC -> ACTGGGATGCG
ACTGGGATGCG -> CTGGGATGCGA
CTGGGATGCGA -> TGGGATGCGAG
TGGGATGCGAG -> GGGATGCGAGG
GGGATGCGAGG -> GGATGCGAGGG
GGATGCGAGGG -> GATGCGAGGGT
GATGCGAGGGT -> ATGCGAGGGTG
ATGCGAGGGTG -> TGCGAGGGTGC
TGCGAGGGTGC -> GCGAGGGTGCA
GCGAGGGTGCA -> CGAGGGTGCAG
CGAGGGTGCAG -> GAGGGTGCAGA
GAGGGTGCAGA -> AGGGTGCAGAG
AGGGTGCAGAG -> GGGTGCAGAGG
GGGTGCAGAGG -> GGTGCAGAGGT
GGTGCAGAGGT -> GTGCAGAGGTT
GTGCAGAGGTT -> TGCAGAGGTTG
TGCAGAGGTTG -> GCAGAGGTTGT
GCAGAGGTTGT -> CAGAGGTTGTC
CAGAGGTTGTC -> AGAGGTTGTCG
AGAGGTTGTCG -> GAGGTTGTCGA
GAGGTTGTCGA -> AGGTTGTCGAC
AGGTTGTCGAC -> GGTTGTCGACT
GGTTGTCGACT -> GTTGTCGACTT
GTTGTCGACTT -> TTGTCGACTTG
TTGTCGACTTG -> TGTCGACTTGC
TGTCGACTTGC -> GTCGACTTGCG
GTCGACTTGCG -> TCGACTTGCGG
TCGACTTGCGG -> CGACTTGCGGG
CGACTTGCGGG -> GACTTGCGGGG
GACTTGCGGGG -> ACTTGCGGGGG
ACTTGCGGGGG -> CTTGCGGGGGC
CTTGCGGGGGC -> TTGCGGGGGCT
TTGCGGGGGCT -> TGCGGGGGCTT
TGCGGGGGCTT -> GCGGGGGCTTT
GCGGGGGCTTT -> CGGGGGCTTTC
CGGGGGCTTTC -> GGGGGCTTTCT
GGGGGCTTTCT -> GGGGCTTTCTG
GGGGCTTTCTG -> GGGCTTTCTGC
GGGCTTTCTGC -> GGCTTTCTGCT
GGCTTTCTGCT -> GCTTTCTGCTC
GCTTTCTGCTC -> CTTTCTGCTCT
CTTTCTGCTCT -> TTTCTGCTCTA
TTTCTGCTCTA -> TTCTGCTCTAA
TTCTGCTCTAA -> TCTGCTCTAAT
TCTGCTCTAAT -> CTGCTCTAATA
CTGCTCTAATA -> TGCTCTAATAC
TGCTCTAATAC -> GCTCTAATACC
GCTCTAATACC -> CTCTAATACCC
CTCTAATACCC -> TCTAATACCCT
TCTAATACCCT -> CTAATACCCTC
CTAATACCCTC -> TAATACCCTCC
TAATACCCTCC -> AATACCCTCCC
AATACCCTCCC -> ATACCCTCCCC
ATACCCTCCCC -> TACCCTCCCCC
TACCCTCCCCC -> ACCCTCCCCCC
ACCCTCCCCCC -> CCCTCCCCCCT
CCCTCCCCCCT -> CCTCCCCCCTC
CCTCCCCCCTC -> CTCCCCCCTCC
CTCCCCCCTCC -> TCCCCCCTCCT
TCCCCCCTCCT -> CCCCCCTCCTC
CCCCCCTCCTC -> CCCCCTCCTCA
CCCCCTCCTCA -> CCCCTCCTCAC
CCCCTCCTCAC -> CCCTCCTCACG
CCCTCCTCACG -> CCTCCTCACGC
CCTCCTCACGC -> CTCCTCACGCA
CTCCTCACGCA -> TCCTCACGCAT
TCCTCACGCAT -> CCTCACGCATG
CCTCACGCATG -> CTCACGCATGC
CTCACGCATGC -> TCACGCATGCT
TCACGCATGCT -> CACGCATGCTG
CACGCATGCTG -> ACGCATGCTGT
ACGCATGCTGT -> CGCATGCTGTC
CGCATGCTGTC -> GCATGCTGTCG
GCATGCTGTCG -> CATGCTGTCGG
CATGCTGTCGG -> ATGCTGTCGGT
ATGCTGTCGGT -> TGCTGTCGGTT
TGCTGTCGGTT -> GCTGTCGGTTA
GCTGTCGGTTA -> CTGTCGGTTAG
CTGTCGGTTAG -> TGTCGGTTAGC
TGTCGGTTAGC -> GTCGGTTAGCG
GTCGGTTAGCG -> TCGGTTAGCGA
TCGGTTAGCGA -> CGGTTAGCGAC
CGGTTAGCGAC -> GGTTAGCGACT
GGTTAGCGACT -> GTTAGCGACTA
GTTAGCGACTA -> TTAGCGACTAG
TTAGCGACTAG -> TAGCGACTAGT
TAGCGACTAGT -> AGCGACTAGTT
AGCGACTAGTT -> GCGACTAGTTG
GCGACTAGTTG -> CGACTAGTTGA
CGACTAGTTGA -> GACTAGTTGAA
GACTAGTTGAA -> ACTAGTTGAAA
ACTAGTTGAAA -> CTAGTTGAAAG
CTAGTTGAAAG -> TAGTTGAAAGG
TAGTTGAAAGG -> AGTTGAAAGGG
AGTTGAAAGGG -> GTTGAAAGGGG
GTTGAAAGGGG -> TTGAAAGGGGA
TTGAAAGGGGA -> TGAAAGGGGAC
TGAAAGGGGAC -> GAAAGGGGACA
GAAAGGGGACA -> AAAGGGGACAA
AAAGGGGACAA -> AAGGGGACAAA
AAGGGGACAAA -> AGGGGACAAAG
AGGGGACAAAG -> GGGGACAAAGT
GGGGACAAAGT -> GGGACAAAGTG
GGGACAAAGTG -> GGACAAAGTGT
GGACAAAGTGT -> GACAAAGTGTT
GACAAAGTGTT -> ACAAAGTGTTA
ACAAAGTGTTA -> CAAAGTGTTAG
CAAAGTGTTAG -> AAAGTGTTAGA
AAAGTGTTAGA -> AAGTGTTAGAG
AAGTGTTAGAG -> AGTGTTAGAGC
AGTGTTAGAGC -> GTGTTAGAGCT
GTGTTAGAGCT -> TGTTAGAGCTG
TGTTAGAGCTG -> GTTAGAGCTGC
GTTAGAGCTGC -> TTAGAGCTGCT
TTAGAGCTGCT -> TAGAGCTGCTG
TAGAGCTGCTG -> AGAGCTGCTGT
AGAGCTGCTGT -> GAGCTGCTGTG
GAGCTGCTGTG -> AGCTGCTGTGA
AGCTGCTGTGA -> GCTGCTGTGAG
GCTGCTGTGAG -> CTGCTGTGAGC
CTGCTGTGAGC -> TGCTGTGAGCA
TGCTGTGAGCA -> GCTGTGAGCAT
GCTGTGAGCAT -> CTGTGAGCATC
CTGTGAGCATC -> TGTGAGCATCG
TGTGAGCATCG -> GTGAGCATCGA
GTGAGCATCGA -> TGAGCATCGAG
TGAGCATCGAG -> GAGCATCGAGC
GAGCATCGAGC -> AGCATCGAGCT
AGCATCGAGCT -> GCATCGAGCTC
GCATCGAGCTC -> CATCGAGCTCC
CATCGAGCTCC -> ATCGAGCTCCG
ATCGAGCTCCG -> TCGAGCTCCGA
TCGAGCTCCGA -> CGAGCTCCGAG
CGAGCTCCGAG -> GAGCTCCGAGG
GAGCTCCGAGG -> AGCTCCGAGGT
AGCTCCGAGGT -> GCTCCGAGGTC
GCTCCGAGGTC -> CTCCGAGGTCG
CTCCGAGGTCG -> TCCGAGGTCGT
CCGAGGTCGTG -> CGAGGTCGTGA
CGAGGTCGTGA -> GAGGTCGTGAA
GAGGTCGTGAA -> AGGTCGTGAAC
AGGTCGTGAAC -> GGTCGTGAACG
GGTCGTGAACG -> GTCGTGAACGT
GTCGTGAACGT -> TCGTGAACGTT
TCGTGAACGTT -> CGTGAACGTTA
CGTGAACGTTA -> GTGAACGTTAC
GTGAACGTTAC -> TGAACGTTACA
TGAACGTTACA -> GAACGTTACAC
GAACGTTACAC -> AACGTTACACG
AACGTTACACG -> ACGTTACACGG
ACGTTACACGG -> CGTTACACGGC
CGTTACACGGC -> GTTACACGGCA
GTTACACGGCA -> TTACACGGCAT
TTACACGGCAT -> TACACGGCATA
TACACGGCATA -> ACACGGCATAG
ACACGGCATAG -> CACGGCATAGC
CACGGCATAGC -> ACGGCATAGCA
ACGGCATAGCA -> CGGCATAGCAC
CGGCATAGCAC -> GGCATAGCACC
GGCATAGCACC -> GCATAGCACCG
GCATAGCACCG -> CATAGCACCGT
CATAGCACCGT -> ATAGCACCGTT
ATAGCACCGTT -> TAGCACCGTTA
