GAAGTGAGTATTCTACTGCT -> AAGTGAGTATTCTACTGCTG
CCGCATCAGGGACCAGAGAC -> CGCATCAGGGACCAGAGACT
GGGCGGACGCGTGAGGAACG -> GGCGGACGCGTGAGGAACGT
GTTTCTAGGTAATCCTAGGA -> TTTCTAGGTAATCCTAGGAT
AGAATTAACTTTCGCGGTGT -> GAATTAACTTTCGCGGTGTC
CGACTCAACACACCCAGTGA -> GACTCAACACACCCAGTGAG
GTAACCATAAGTAGCAGGTA -> TAACCATAAGTAGCAGGTAC
GGACCGGATCGGAACCAAGC -> GACCGGATCGGAACCAAGCC
CGACGGCCTTGCTAAGCTAA -> GACGGCCTTGCTAAGCTAAT
CGCAACCTGACAGCCAAACC -> GCAACCTGACAGCCAAACCA
GGGAAGATAGCTGTATCGAA -> GGAAGATAGCTGTATCGAAG
CCACGGGACACGCCTGATGA -> CACGGGACACGCCTGATGAA
CAGATGGACAACTTTTGGAT -> AGATGGACAACTTTTGGATT
ATCTGTATAAAAGTCTGCTA -> TCTGTATAAAAGTCTGCTAT
AGATGGGTATGTTTTAAATT -> GATGGGTATGTTTTAAATTC
TTAGGTCTTGGTGACCAACG -> TAGGTCTTGGTGACCAACGC
TCAAATAGAGGTAACCATAA -> CAAATAGAGGTAACCATAAG
ACAAGGGGACGACTCAACAC -> CAAGGGGACGACTCAACACA
AGAACTTATATGAGCCCGCA -> GAACTTATATGAGCCCGCAA
ACAGTCTGTAATTATCGGGC -> CAGTCTGTAATTATCGGGCG
CTCCGGCTATGTGGAAATAC -> TCCGGCTATGTGGAAATACA
CAGTGAGGCCGACGGCCTTG -> AGTGAGGCCGACGGCCTTGC
ACCTGAAAGAGAGGGACTGC -> CCTGAAAGAGAGGGACTGCG
GTCTTGGTGACCAACGCGGC -> TCTTGGTGACCAACGCGGCT
AGCCAAACCAGCCTACATGC -> GCCAAACCAGCCTACATGCA
TGAGTTTGTGCCATCTGGCT -> GAGTTTGTGCCATCTGGCTC
GAAGTGTTGAGTTTGTGCCA -> AAGTGTTGAGTTTGTGCCAT
CTAAGCTAATCCACAGGCAT -> TAAGCTAATCCACAGGCATG
AAGCTCTTTAGTTACAACGG -> AGCTCTTTAGTTACAACGGA
ACGGGACACGCCTGATGAAC -> CGGGACACGCCTGATGAACG
CACGCCTGATGAACGGCGCC -> ACGCCTGATGAACGGCGCCC
TAGTTAGAGATTCCGAACGA -> AGTTAGAGATTCCGAACGAC
TTGTCTTAGGCGCTAACTTT -> TGTCTTAGGCGCTAACTTTT
TGTATGGTATGTGCCAGTGC -> GTATGGTATGTGCCAGTGCG
GCAGTGAGGCCGACGGCCTT -> CAGTGAGGCCGACGGCCTTG
CAGGGACCAGAGACTGTATG -> AGGGACCAGAGACTGTATGG
GCCCTTTGAGGACATCAAAC -> CCCTTTGAGGACATCAAACT
CTGAAACTATATGGAACCTG -> TGAAACTATATGGAACCTGG
AATCTGGTCAGATGGACAAC -> ATCTGGTCAGATGGACAACT
GGATCGGAACCAAGCCTTGA -> GATCGGAACCAAGCCTTGAC
TAGTTACAACGGATGCAATG -> AGTTACAACGGATGCAATGG
GGCTTAGTTAGAGATTCCGA -> GCTTAGTTAGAGATTCCGAA
ATGCAATGGAGTCAAATAGA -> TGCAATGGAGTCAAATAGAG
GGAGTCAAATAGAGGTAACC -> GAGTCAAATAGAGGTAACCA
AGGCAGTGAGGCCGACGGCC -> GGCAGTGAGGCCGACGGCCT
TGTTTTAAATTCTCTAGCGG -> GTTTTAAATTCTCTAGCGGC
GCCATCTGGCTCCCCTAGGC -> CCATCTGGCTCCCCTAGGCG
GCCTTGCTAAGCTAATCCAC -> CCTTGCTAAGCTAATCCACA
ATTTTCCGTGCACATGGACT -> TTTTCCGTGCACATGGACTC
GGGTGGAGATAGATCTCCGG -> GGTGGAGATAGATCTCCGGC
TTGTGTGATGTCCACGGGAC -> TGTGTGATGTCCACGGGACA
TGGACCGGATCGGAACCAAG -> GGACCGGATCGGAACCAAGC
ACACCCAGTGAGAGAGCTTG -> CACCCAGTGAGAGAGCTTGC
TAAGCTAATCCACAGGCATG -> AAGCTAATCCACAGGCATGT
GTTCCGCAACCTGACAGCCA -> TTCCGCAACCTGACAGCCAA
CCTGACAGCCAAACCAGCCT -> CTGACAGCCAAACCAGCCTA
GGCGCTAACTTTTCATGAAA -> GCGCTAACTTTTCATGAAAG
GTTAGGTCTTGGTGACCAAC -> TTAGGTCTTGGTGACCAACG
AGTTTGTGCCATCTGGCTCC -> GTTTGTGCCATCTGGCTCCC
CCTGGGCGATTTCGCGATGG -> CTGGGCGATTTCGCGATGGG
CCAGTGAGAGAGCTTGCCTT -> CAGTGAGAGAGCTTGCCTTG
TACCTGAAAGAGAGGGACTG -> ACCTGAAAGAGAGGGACTGC
CGCCTGATGAACGGCGCCCG -> GCCTGATGAACGGCGCCCGG
AGGTACCTGAAAGAGAGGGA -> GGTACCTGAAAGAGAGGGAC
CCATAAGTAGCAGGTACCTG -> CATAAGTAGCAGGTACCTGA
GGCCGATATTATTTGTGTGA -> GCCGATATTATTTGTGTGAT
CAGAAGTGTTGAGTTTGTGC -> AGAAGTGTTGAGTTTGTGCC
ACCCAGTGAGAGAGCTTGCC -> CCCAGTGAGAGAGCTTGCCT
GAACGACAGTCTGTAATTAT -> AACGACAGTCTGTAATTATC
ACCGAAAGAGAGGGACTGGG -> CCGAAAGAGAGGGACTGGGA
CCGGATCGGAACCAAGCCTT -> CGGATCGGAACCAAGCCTTG
TTTGTGTGATGTCCACGGGA -> TTGTGTGATGTCCACGGGAC
ACCTGACAGCCAAACCAGCC -> CCTGACAGCCAAACCAGCCT
TTGCCCTTTGAGGACATCAA -> TGCCCTTTGAGGACATCAAA
ACGCCTGATGAACGGCGCCC -> CGCCTGATGAACGGCGCCCG
ATCCTAGGATGTTGGACCGG -> TCCTAGGATGTTGGACCGGA
AGCCTACATGCAGAAGTGTT -> GCCTACATGCAGAAGTGTTG
CCCCCATGTCGAATTCTGAA -> CCCCATGTCGAATTCTGAAA
AGATGGACAACTTTTGGATT -> GATGGACAACTTTTGGATTT
AATTCTCTAGCGGCCGATAT -> ATTCTCTAGCGGCCGATATT
AACGTTTTGTCTTAGGCGCT -> ACGTTTTGTCTTAGGCGCTA
CAACCTGACAGCCAAACCAG -> AACCTGACAGCCAAACCAGC
AACACACCCAGTGAGAGAGC -> ACACACCCAGTGAGAGAGCT
CTGGTTCCGCAACCTGACAG -> TGGTTCCGCAACCTGACAGC
CTTTCGCGGTGTCGATTGCC -> TTTCGCGGTGTCGATTGCCC
CCGGCTTATCAGATGGGTAT -> CGGCTTATCAGATGGGTATG
GGTAATCCTAGGATGTTGGA -> GTAATCCTAGGATGTTGGAC
GTAATCCTAGGATGTTGGAC -> TAATCCTAGGATGTTGGACC
TATATGAGCCCGCAACACGT -> ATATGAGCCCGCAACACGTT
AAAGAGAGGGACTGCGTAAG -> AAGAGAGGGACTGCGTAAGA
TTCAATCTGGTCAGATGGAC -> TCAATCTGGTCAGATGGACA
TCAAACTTGGGGTTTCTAGG -> CAAACTTGGGGTTTCTAGGT
CTACTGCTGGTTCCGCAACC -> TACTGCTGGTTCCGCAACCT
AAATTCTCTAGCGGCCGATA -> AATTCTCTAGCGGCCGATAT
GAAAGTTTGCGAAAGGGGAC -> AAAGTTTGCGAAAGGGGACT
AACTATATGGAACCTGGGCG -> ACTATATGGAACCTGGGCGA
CCAACGCGGCTCACGGCAAA -> CAACGCGGCTCACGGCAAAG
ATGGTATGTGCCAGTGCGTA -> TGGTATGTGCCAGTGCGTAT
CCATTTTATGGCTTAGTTAG -> CATTTTATGGCTTAGTTAGA
AAGTGAGTATTCTACTGCTG -> AGTGAGTATTCTACTGCTGG
CGGCGCCCGGGTCTAATTTA -> GGCGCCCGGGTCTAATTTAG
TAGGCGCCACCGCATCAGGG -> AGGCGCCACCGCATCAGGGA
GACTCAACTCTCGAATAACC -> ACTCAACTCTCGAATAACCG
GACTGCGTAAGAATTAACTT -> ACTGCGTAAGAATTAACTTT
AATTCTGAAACTATATGGAA -> ATTCTGAAACTATATGGAAC
TCTTGGTGACCAACGCGGCT -> CTTGGTGACCAACGCGGCTC
CGTTTTAACAAGGGGACGAC -> GTTTTAACAAGGGGACGACT
GACAGTCTGTAATTATCGGG -> ACAGTCTGTAATTATCGGGC
GTACCTGAAAGAGAGGGACT -> TACCTGAAAGAGAGGGACTG
AGTGAGAGAGCTTGCCTTGA -> GTGAGAGAGCTTGCCTTGAT
ATGCAGAAGTGTTGAGTTTG -> TGCAGAAGTGTTGAGTTTGT
CATGCAGAAGTGTTGAGTTT -> ATGCAGAAGTGTTGAGTTTG
GTATGTTTTAAATTCTCTAG -> TATGTTTTAAATTCTCTAGC
AGTAGCAGGTACCTGAAAGA -> GTAGCAGGTACCTGAAAGAG
TGCCTTGATCTACAGCGGCT -> GCCTTGATCTACAGCGGCTC
CTCTAGCGGCCGATATTATT -> TCTAGCGGCCGATATTATTT
CTAATTTAGGTGTTGATCTG -> TAATTTAGGTGTTGATCTGT
TGATGAACGGCGCCCGGGTC -> GATGAACGGCGCCCGGGTCT
CCCCCCATGTCGAATTCTGA -> CCCCCATGTCGAATTCTGAA
TTTCTACAGCTCGACTCCCC -> TTCTACAGCTCGACTCCCCC
GAACGTTTTGTCTTAGGCGC -> AACGTTTTGTCTTAGGCGCT
ACCAACGCGGCTCACGGCAA -> CCAACGCGGCTCACGGCAAA
CTGCGTAAGAATTAACTTTC -> TGCGTAAGAATTAACTTTCG
AATAACCGAAAGAGAGGGAC -> ATAACCGAAAGAGAGGGACT
TGAAGGCAGTGAGGCCGACG -> GAAGGCAGTGAGGCCGACGG
ACAGCTCGACTCCCCCCCCA -> CAGCTCGACTCCCCCCCCAT
ATTCTACTGCTGGTTCCGCA -> TTCTACTGCTGGTTCCGCAA
GCTAATCCACAGGCATGTTG -> CTAATCCACAGGCATGTTGA
GGCGATTTCGCGATGGGTTA -> GCGATTTCGCGATGGGTTAG
TTGATCTGTATAAAAGTCTG -> TGATCTGTATAAAAGTCTGC
GCTCACGGCAAAGTAGGGGT -> CTCACGGCAAAGTAGGGGTG
GCGACGCCTTTGAGAACTTA -> CGACGCCTTTGAGAACTTAT
AAAGGGGACTTACCTCGTCG -> AAGGGGACTTACCTCGTCGA
CTGAAAGAGAGGGACTGCGT -> TGAAAGAGAGGGACTGCGTA
AGTTTCAATCTGGTCAGATG -> GTTTCAATCTGGTCAGATGG
CGTTTTGTCTTAGGCGCTAA -> GTTTTGTCTTAGGCGCTAAC
TTTGTGCCATCTGGCTCCCC -> TTGTGCCATCTGGCTCCCCT
GGTTCCGCAACCTGACAGCC -> GTTCCGCAACCTGACAGCCA
TGGACAACTTTTGGATTTCT -> GGACAACTTTTGGATTTCTA
CTCACGGCAAAGTAGGGGTG -> TCACGGCAAAGTAGGGGTGG
CAAGCTCTTTAGTTACAACG -> AAGCTCTTTAGTTACAACGG
TTTGGATTTCTACAGCTCGA -> TTGGATTTCTACAGCTCGAC
GGCTCCCGGCTTATCAGATG -> GCTCCCGGCTTATCAGATGG
GGTCAGATGGACAACTTTTG -> GTCAGATGGACAACTTTTGG
CCCTAGGCGCCACCGCATCA -> CCTAGGCGCCACCGCATCAG
GCTAAGCTAATCCACAGGCA -> CTAAGCTAATCCACAGGCAT
ATTTGTGTGATGTCCACGGG -> TTTGTGTGATGTCCACGGGA
GTTTGCGAAAGGGGACTTAC -> TTTGCGAAAGGGGACTTACC
AACGCGGCTCACGGCAAAGT -> ACGCGGCTCACGGCAAAGTA
AAGTGTTGAGTTTGTGCCAT -> AGTGTTGAGTTTGTGCCATC
TTCTACTGCTGGTTCCGCAA -> TCTACTGCTGGTTCCGCAAC
TTGCCTTGATCTACAGCGGC -> TGCCTTGATCTACAGCGGCT
CCTAGGATGTTGGACCGGAT -> CTAGGATGTTGGACCGGATC
ACCATTTTATGGCTTAGTTA -> CCATTTTATGGCTTAGTTAG
GCGATGGGTTAGGTCTTGGT -> CGATGGGTTAGGTCTTGGTG
TTCGCGGTGTCGATTGCCCT -> TCGCGGTGTCGATTGCCCTT
CTGTATCGAAGTGAGTATTC -> TGTATCGAAGTGAGTATTCT
AGATTCCGAACGACAGTCTG -> GATTCCGAACGACAGTCTGT
AACCTGACAGCCAAACCAGC -> ACCTGACAGCCAAACCAGCC
GTGCACATGGACTCAACTCT -> TGCACATGGACTCAACTCTC
ACACGCCTGATGAACGGCGC -> CACGCCTGATGAACGGCGCC
GGACAACTTTTGGATTTCTA -> GACAACTTTTGGATTTCTAC
GTAGCAGGTACCTGAAAGAG -> TAGCAGGTACCTGAAAGAGA
TGCTAAGCTAATCCACAGGC -> GCTAAGCTAATCCACAGGCA
CCGGCTATGTGGAAATACAG -> CGGCTATGTGGAAATACAGG
TAGCAGGTACCTGAAAGAGA -> AGCAGGTACCTGAAAGAGAG
CGCCCGGGTCTAATTTAGGT -> GCCCGGGTCTAATTTAGGTG
AAAGTTTGCGAAAGGGGACT -> AAGTTTGCGAAAGGGGACTT
AACGACAGTCTGTAATTATC -> ACGACAGTCTGTAATTATCG
GTTGAGTTTGTGCCATCTGG -> TTGAGTTTGTGCCATCTGGC
GGGTTAGGTCTTGGTGACCA -> GGTTAGGTCTTGGTGACCAA
GACCAACGCGGCTCACGGCA -> ACCAACGCGGCTCACGGCAA
ACTGTATGGTATGTGCCAGT -> CTGTATGGTATGTGCCAGTG
TTGACTGAAGGCAGTGAGGC -> TGACTGAAGGCAGTGAGGCC
ACTTTTGGATTTCTACAGCT -> CTTTTGGATTTCTACAGCTC
GCTGTATCGAAGTGAGTATT -> CTGTATCGAAGTGAGTATTC
AGGTGTTGATCTGTATAAAA -> GGTGTTGATCTGTATAAAAG
GTGAGGCCGACGGCCTTGCT -> TGAGGCCGACGGCCTTGCTA
GACCTGCGACGCCTTTGAGA -> ACCTGCGACGCCTTTGAGAA
GCGGCCGATATTATTTGTGT -> CGGCCGATATTATTTGTGTG
GTAGGGGTGGAGATAGATCT -> TAGGGGTGGAGATAGATCTC
TACAGGTGACCTGCGACGCC -> ACAGGTGACCTGCGACGCCT
AGTTTGCGAAAGGGGACTTA -> GTTTGCGAAAGGGGACTTAC
TCGACTCCCCCCCCATGTCG -> CGACTCCCCCCCCATGTCGA
CTCTCGAATAACCGAAAGAG -> TCTCGAATAACCGAAAGAGA
GTTCCGAACATGAGTTTCAA -> TTCCGAACATGAGTTTCAAT
GGTCTTGGTGACCAACGCGG -> GTCTTGGTGACCAACGCGGC
GTGACCTGCGACGCCTTTGA -> TGACCTGCGACGCCTTTGAG
GGGCGATTTCGCGATGGGTT -> GGCGATTTCGCGATGGGTTA
TGTATCGAAGTGAGTATTCT -> GTATCGAAGTGAGTATTCTA
CACCCAGTGAGAGAGCTTGC -> ACCCAGTGAGAGAGCTTGCC
CAACACGTTTTAACAAGGGG -> AACACGTTTTAACAAGGGGA
TCTGAAACTATATGGAACCT -> CTGAAACTATATGGAACCTG
GAGAACTTATATGAGCCCGC -> AGAACTTATATGAGCCCGCA
ACCAAGCCTTGACTGAAGGC -> CCAAGCCTTGACTGAAGGCA
CGCGGCTCACGGCAAAGTAG -> GCGGCTCACGGCAAAGTAGG
GAGGTAACCATAAGTAGCAG -> AGGTAACCATAAGTAGCAGG
TGTGCCATCTGGCTCCCCTA -> GTGCCATCTGGCTCCCCTAG
CCACCGCATCAGGGACCAGA -> CACCGCATCAGGGACCAGAG
CCTTTGAGAACTTATATGAG -> CTTTGAGAACTTATATGAGC
GAACTTATATGAGCCCGCAA -> AACTTATATGAGCCCGCAAC
TCTACAGCTCGACTCCCCCC -> CTACAGCTCGACTCCCCCCC
CCCCCCCATGTCGAATTCTG -> CCCCCCATGTCGAATTCTGA
GATGAACGGCGCCCGGGTCT -> ATGAACGGCGCCCGGGTCTA
TTAACTTTCGCGGTGTCGAT -> TAACTTTCGCGGTGTCGATT
CCATGTCGAATTCTGAAACT -> CATGTCGAATTCTGAAACTA
GGGACTTACCTCGTCGACGT -> GGACTTACCTCGTCGACGTC
TAACCATAAGTAGCAGGTAC -> AACCATAAGTAGCAGGTACC
CCATCTGGCTCCCCTAGGCG -> CATCTGGCTCCCCTAGGCGC
AATGGAGTCAAATAGAGGTA -> ATGGAGTCAAATAGAGGTAA
CTTTGAGAACTTATATGAGC -> TTTGAGAACTTATATGAGCC
ATCAGATGGGTATGTTTTAA -> TCAGATGGGTATGTTTTAAA
GTCGATTGCCCTTTGAGGAC -> TCGATTGCCCTTTGAGGACA
AGTGAGGCCGACGGCCTTGC -> GTGAGGCCGACGGCCTTGCT
ATAGCTGTATCGAAGTGAGT -> TAGCTGTATCGAAGTGAGTA
CGGATCGGAACCAAGCCTTG -> GGATCGGAACCAAGCCTTGA
AGAGACTGTATGGTATGTGC -> GAGACTGTATGGTATGTGCC
ATGGGTATGTTTTAAATTCT -> TGGGTATGTTTTAAATTCTC
ACAGCCAAACCAGCCTACAT -> CAGCCAAACCAGCCTACATG
CCTGAAAGAGAGGGACTGCG -> CTGAAAGAGAGGGACTGCGT
ACCGCATCAGGGACCAGAGA -> CCGCATCAGGGACCAGAGAC
CGATTTCGCGATGGGTTAGG -> GATTTCGCGATGGGTTAGGT
GCTCCCGGCTTATCAGATGG -> CTCCCGGCTTATCAGATGGG
TTTCGCGATGGGTTAGGTCT -> TTCGCGATGGGTTAGGTCTT
GACTGGGAAGATAGCTGTAT -> ACTGGGAAGATAGCTGTATC
ATCAAACTTGGGGTTTCTAG -> TCAAACTTGGGGTTTCTAGG
ATAAGTAGCAGGTACCTGAA -> TAAGTAGCAGGTACCTGAAA
ACTTACCTCGTCGACGTCAA -> CTTACCTCGTCGACGTCAAG
GACTGAAGGCAGTGAGGCCG -> ACTGAAGGCAGTGAGGCCGA
TAGCGGCCGATATTATTTGT -> AGCGGCCGATATTATTTGTG
ACACGTTTTAACAAGGGGAC -> CACGTTTTAACAAGGGGACG
TGCCCTTTGAGGACATCAAA -> GCCCTTTGAGGACATCAAAC
GTTTGTGCCATCTGGCTCCC -> TTTGTGCCATCTGGCTCCCC
CACGTTTTAACAAGGGGACG -> ACGTTTTAACAAGGGGACGA
GTTTTAAATTCTCTAGCGGC -> TTTTAAATTCTCTAGCGGCC
CAACTTTTGGATTTCTACAG -> AACTTTTGGATTTCTACAGC
TGCTATTTTCCGTGCACATG -> GCTATTTTCCGTGCACATGG
TTTTGGATTTCTACAGCTCG -> TTTGGATTTCTACAGCTCGA
CAGCGGCTCCCGGCTTATCA -> AGCGGCTCCCGGCTTATCAG
GGCAAAGTAGGGGTGGAGAT -> GCAAAGTAGGGGTGGAGATA
CCAAACCAGCCTACATGCAG -> CAAACCAGCCTACATGCAGA
ACCAGAGACTGTATGGTATG -> CCAGAGACTGTATGGTATGT
TCGGAACCAAGCCTTGACTG -> CGGAACCAAGCCTTGACTGA
GGAAGATAGCTGTATCGAAG -> GAAGATAGCTGTATCGAAGT
GACCAGAGACTGTATGGTAT -> ACCAGAGACTGTATGGTATG
CGGACGCGTGAGGAACGTTT -> GGACGCGTGAGGAACGTTTT
GAGTTTCAATCTGGTCAGAT -> AGTTTCAATCTGGTCAGATG
TCTGCTATTTTCCGTGCACA -> CTGCTATTTTCCGTGCACAT
GTGTCGATTGCCCTTTGAGG -> TGTCGATTGCCCTTTGAGGA
TGCGTAAGAATTAACTTTCG -> GCGTAAGAATTAACTTTCGC
GGCTCCCCTAGGCGCCACCG -> GCTCCCCTAGGCGCCACCGC
ACTCAACACACCCAGTGAGA -> CTCAACACACCCAGTGAGAG
AAGTTTGCGAAAGGGGACTT -> AGTTTGCGAAAGGGGACTTA
TGGTTCCGCAACCTGACAGC -> GGTTCCGCAACCTGACAGCC
AGCAGGTACCTGAAAGAGAG -> GCAGGTACCTGAAAGAGAGG
CTCCCCCCCCATGTCGAATT -> TCCCCCCCCATGTCGAATTC
GCAACCTGACAGCCAAACCA -> CAACCTGACAGCCAAACCAG
GGTACCTGAAAGAGAGGGAC -> GTACCTGAAAGAGAGGGACT
CAGGTACCTGAAAGAGAGGG -> AGGTACCTGAAAGAGAGGGA
GGCGGACGCGTGAGGAACGT -> GCGGACGCGTGAGGAACGTT
GCGGCTCACGGCAAAGTAGG -> CGGCTCACGGCAAAGTAGGG
TATGGCTTAGTTAGAGATTC -> ATGGCTTAGTTAGAGATTCC
GGGTATGTTTTAAATTCTCT -> GGTATGTTTTAAATTCTCTA
AGTCAAATAGAGGTAACCAT -> GTCAAATAGAGGTAACCATA
GCGGACGCGTGAGGAACGTT -> CGGACGCGTGAGGAACGTTT
CTCGTCGACGTCAAGCTCTT -> TCGTCGACGTCAAGCTCTTT
GTGTTGAGTTTGTGCCATCT -> TGTTGAGTTTGTGCCATCTG
CTCAACTCTCGAATAACCGA -> TCAACTCTCGAATAACCGAA
TACCTCGTCGACGTCAAGCT -> ACCTCGTCGACGTCAAGCTC
CTAGCGGCCGATATTATTTG -> TAGCGGCCGATATTATTTGT
TCCTAGGATGTTGGACCGGA -> CCTAGGATGTTGGACCGGAT
TCGAATTCTGAAACTATATG -> CGAATTCTGAAACTATATGG
GGTGTCGATTGCCCTTTGAG -> GTGTCGATTGCCCTTTGAGG
GTTAGAGATTCCGAACGACA -> TTAGAGATTCCGAACGACAG
TTCCGTGCACATGGACTCAA -> TCCGTGCACATGGACTCAAC
AGAGGGACTGCGTAAGAATT -> GAGGGACTGCGTAAGAATTA
TGTTGATCTGTATAAAAGTC -> GTTGATCTGTATAAAAGTCT
TGTCGATTGCCCTTTGAGGA -> GTCGATTGCCCTTTGAGGAC
ACTCAACTCTCGAATAACCG -> CTCAACTCTCGAATAACCGA
AATTATCGGGCGGACGCGTG -> ATTATCGGGCGGACGCGTGA
ACTTTTCATGAAAGTTTGCG -> CTTTTCATGAAAGTTTGCGA
GAATTAACTTTCGCGGTGTC -> AATTAACTTTCGCGGTGTCG
ACGGATGCAATGGAGTCAAA -> CGGATGCAATGGAGTCAAAT
AGAGGGACTGGGAAGATAGC -> GAGGGACTGGGAAGATAGCT
AAAGAGAGGGACTGGGAAGA -> AAGAGAGGGACTGGGAAGAT
AAAAGTCTGCTATTTTCCGT -> AAAGTCTGCTATTTTCCGTG
CTTTGAGGACATCAAACTTG -> TTTGAGGACATCAAACTTGG
GACTTACCTCGTCGACGTCA -> ACTTACCTCGTCGACGTCAA
GAGAGCTTGCCTTGATCTAC -> AGAGCTTGCCTTGATCTACA
CTTACCTCGTCGACGTCAAG -> TTACCTCGTCGACGTCAAGC
GACAGCCAAACCAGCCTACA -> ACAGCCAAACCAGCCTACAT
CTAACTTTTCATGAAAGTTT -> TAACTTTTCATGAAAGTTTG
CTATATGGAACCTGGGCGAT -> TATATGGAACCTGGGCGATT
TCGACGTCAAGCTCTTTAGT -> CGACGTCAAGCTCTTTAGTT
CGATGGGTTAGGTCTTGGTG -> GATGGGTTAGGTCTTGGTGA
TATTTTCCGTGCACATGGAC -> ATTTTCCGTGCACATGGACT
ACATCAAACTTGGGGTTTCT -> CATCAAACTTGGGGTTTCTA
ATTTTATGGCTTAGTTAGAG -> TTTTATGGCTTAGTTAGAGA
CTTAGTTAGAGATTCCGAAC -> TTAGTTAGAGATTCCGAACG
GAACATGAGTTTCAATCTGG -> AACATGAGTTTCAATCTGGT
TGAAAGTTTGCGAAAGGGGA -> GAAAGTTTGCGAAAGGGGAC
GTGATGTCCACGGGACACGC -> TGATGTCCACGGGACACGCC
CCCACCATTTTATGGCTTAG -> CCACCATTTTATGGCTTAGT
CTCAACACACCCAGTGAGAG -> TCAACACACCCAGTGAGAGA
AGGTCTTGGTGACCAACGCG -> GGTCTTGGTGACCAACGCGG
CGAAAGAGAGGGACTGGGAA -> GAAAGAGAGGGACTGGGAAG
CTACATGCAGAAGTGTTGAG -> TACATGCAGAAGTGTTGAGT
ATTTCGCGATGGGTTAGGTC -> TTTCGCGATGGGTTAGGTCT
AAAGTCTGCTATTTTCCGTG -> AAGTCTGCTATTTTCCGTGC
AAGTAGCAGGTACCTGAAAG -> AGTAGCAGGTACCTGAAAGA
TGGATTTCTACAGCTCGACT -> GGATTTCTACAGCTCGACTC
CCCCTAGGCGCCACCGCATC -> CCCTAGGCGCCACCGCATCA
ATGAACGGCGCCCGGGTCTA -> TGAACGGCGCCCGGGTCTAA
AAGGGGACGACTCAACACAC -> AGGGGACGACTCAACACACC
CCAAGCCTTGACTGAAGGCA -> CAAGCCTTGACTGAAGGCAG
GAAACTATATGGAACCTGGG -> AAACTATATGGAACCTGGGC
GCGATTTCGCGATGGGTTAG -> CGATTTCGCGATGGGTTAGG
CCACCATTTTATGGCTTAGT -> CACCATTTTATGGCTTAGTT
AGTGAGTATTCTACTGCTGG -> GTGAGTATTCTACTGCTGGT
GCTTATCAGATGGGTATGTT -> CTTATCAGATGGGTATGTTT
GCAGGTACCTGAAAGAGAGG -> CAGGTACCTGAAAGAGAGGG
GGAACCTGGGCGATTTCGCG -> GAACCTGGGCGATTTCGCGA
TCTAATTTAGGTGTTGATCT -> CTAATTTAGGTGTTGATCTG
TGACAGCCAAACCAGCCTAC -> GACAGCCAAACCAGCCTACA
CATCAGGGACCAGAGACTGT -> ATCAGGGACCAGAGACTGTA
AACACGTTTTAACAAGGGGA -> ACACGTTTTAACAAGGGGAC
GAGTTTGTGCCATCTGGCTC -> AGTTTGTGCCATCTGGCTCC
GCGTAAGAATTAACTTTCGC -> CGTAAGAATTAACTTTCGCG
ACGTCAAGCTCTTTAGTTAC -> CGTCAAGCTCTTTAGTTACA
GATCTGTATAAAAGTCTGCT -> ATCTGTATAAAAGTCTGCTA
CCGACGGCCTTGCTAAGCTA -> CGACGGCCTTGCTAAGCTAA
CGTCAAGCTCTTTAGTTACA -> GTCAAGCTCTTTAGTTACAA
AAACTTGGGGTTTCTAGGTA -> AACTTGGGGTTTCTAGGTAA
AGCTGTATCGAAGTGAGTAT -> GCTGTATCGAAGTGAGTATT
ATATGGAACCTGGGCGATTT -> TATGGAACCTGGGCGATTTC
GATAGCTGTATCGAAGTGAG -> ATAGCTGTATCGAAGTGAGT
GCCTTTGAGAACTTATATGA -> CCTTTGAGAACTTATATGAG
CTTTAGTTACAACGGATGCA -> TTTAGTTACAACGGATGCAA
CAGCCAAACCAGCCTACATG -> AGCCAAACCAGCCTACATGC
CGTAAGAATTAACTTTCGCG -> GTAAGAATTAACTTTCGCGG
GAGGACATCAAACTTGGGGT -> AGGACATCAAACTTGGGGTT
TTGGTGACCAACGCGGCTCA -> TGGTGACCAACGCGGCTCAC
AAATACAGGTGACCTGCGAC -> AATACAGGTGACCTGCGACG
TCGTCGACGTCAAGCTCTTT -> CGTCGACGTCAAGCTCTTTA
TCTGTATAAAAGTCTGCTAT -> CTGTATAAAAGTCTGCTATT
TGCGAAAGGGGACTTACCTC -> GCGAAAGGGGACTTACCTCG
GCGGTGTCGATTGCCCTTTG -> CGGTGTCGATTGCCCTTTGA
AGGGGACGACTCAACACACC -> GGGGACGACTCAACACACCC
TATTTGTGTGATGTCCACGG -> ATTTGTGTGATGTCCACGGG
AGCCCGCAACACGTTTTAAC -> GCCCGCAACACGTTTTAACA
AGACTGTATGGTATGTGCCA -> GACTGTATGGTATGTGCCAG
AACCAAGCCTTGACTGAAGG -> ACCAAGCCTTGACTGAAGGC
TTCGCGATGGGTTAGGTCTT -> TCGCGATGGGTTAGGTCTTG
TCAACACACCCAGTGAGAGA -> CAACACACCCAGTGAGAGAG
TTAGTTAGAGATTCCGAACG -> TAGTTAGAGATTCCGAACGA
AGCTCGACTCCCCCCCCATG -> GCTCGACTCCCCCCCCATGT
TAATTTAGGTGTTGATCTGT -> AATTTAGGTGTTGATCTGTA
AGCTCTTTAGTTACAACGGA -> GCTCTTTAGTTACAACGGAT
CGCCACCGCATCAGGGACCA -> GCCACCGCATCAGGGACCAG
CCCCATGTCGAATTCTGAAA -> CCCATGTCGAATTCTGAAAC
AGGCGCCACCGCATCAGGGA -> GGCGCCACCGCATCAGGGAC
ATGTCGAATTCTGAAACTAT -> TGTCGAATTCTGAAACTATA
ATTATCGGGCGGACGCGTGA -> TTATCGGGCGGACGCGTGAG
ACAGGCATGTTGAGTTCCGA -> CAGGCATGTTGAGTTCCGAA
CTGCGACGCCTTTGAGAACT -> TGCGACGCCTTTGAGAACTT
CAGGTGACCTGCGACGCCTT -> AGGTGACCTGCGACGCCTTT
TATTCTACTGCTGGTTCCGC -> ATTCTACTGCTGGTTCCGCA
GGACTTACCTCGTCGACGTC -> GACTTACCTCGTCGACGTCA
ACGCGTGAGGAACGTTTTGT -> CGCGTGAGGAACGTTTTGTC
TCGAAGTGAGTATTCTACTG -> CGAAGTGAGTATTCTACTGC
TCTGGTCAGATGGACAACTT -> CTGGTCAGATGGACAACTTT
AACTTTTGGATTTCTACAGC -> ACTTTTGGATTTCTACAGCT
AAGGGGACTTACCTCGTCGA -> AGGGGACTTACCTCGTCGAC
CCCCCCCCATGTCGAATTCT -> CCCCCCCATGTCGAATTCTG
TTGGATTTCTACAGCTCGAC -> TGGATTTCTACAGCTCGACT
ACACACCCAGTGAGAGAGCT -> CACACCCAGTGAGAGAGCTT
GGACTGCGTAAGAATTAACT -> GACTGCGTAAGAATTAACTT
CTTATATGAGCCCGCAACAC -> TTATATGAGCCCGCAACACG
AGGCGCTAACTTTTCATGAA -> GGCGCTAACTTTTCATGAAA
GATCGGAACCAAGCCTTGAC -> ATCGGAACCAAGCCTTGACT
TAATTATCGGGCGGACGCGT -> AATTATCGGGCGGACGCGTG
AGGAACGTTTTGTCTTAGGC -> GGAACGTTTTGTCTTAGGCG
CTAGGTAATCCTAGGATGTT -> TAGGTAATCCTAGGATGTTG
TGGTGACCAACGCGGCTCAC -> GGTGACCAACGCGGCTCACG
GGACGACTCAACACACCCAG -> GACGACTCAACACACCCAGT
AAGAGAGGGACTGGGAAGAT -> AGAGAGGGACTGGGAAGATA
CGGCTCACGGCAAAGTAGGG -> GGCTCACGGCAAAGTAGGGG
ATTCTCTAGCGGCCGATATT -> TTCTCTAGCGGCCGATATTA
ACATGAGTTTCAATCTGGTC -> CATGAGTTTCAATCTGGTCA
GTCCACGGGACACGCCTGAT -> TCCACGGGACACGCCTGATG
GACACGCCTGATGAACGGCG -> ACACGCCTGATGAACGGCGC
GGTGGAGATAGATCTCCGGC -> GTGGAGATAGATCTCCGGCT
GCGTGAGGAACGTTTTGTCT -> CGTGAGGAACGTTTTGTCTT
CGAATAACCGAAAGAGAGGG -> GAATAACCGAAAGAGAGGGA
GATGGACAACTTTTGGATTT -> ATGGACAACTTTTGGATTTC
AGCTAATCCACAGGCATGTT -> GCTAATCCACAGGCATGTTG
AAACTATATGGAACCTGGGC -> AACTATATGGAACCTGGGCG
TTGCGAAAGGGGACTTACCT -> TGCGAAAGGGGACTTACCTC
GGATGTTGGACCGGATCGGA -> GATGTTGGACCGGATCGGAA
CATGAGTTTCAATCTGGTCA -> ATGAGTTTCAATCTGGTCAG
CACACCCAGTGAGAGAGCTT -> ACACCCAGTGAGAGAGCTTG
CCTTGCTAAGCTAATCCACA -> CTTGCTAAGCTAATCCACAG
CCTTGACTGAAGGCAGTGAG -> CTTGACTGAAGGCAGTGAGG
ATCGGGCGGACGCGTGAGGA -> TCGGGCGGACGCGTGAGGAA
GCGGCTCCCGGCTTATCAGA -> CGGCTCCCGGCTTATCAGAT
AACTTTTCATGAAAGTTTGC -> ACTTTTCATGAAAGTTTGCG
AAGATAGCTGTATCGAAGTG -> AGATAGCTGTATCGAAGTGA
TTCTCTAGCGGCCGATATTA -> TCTCTAGCGGCCGATATTAT
AAACCAGCCTACATGCAGAA -> AACCAGCCTACATGCAGAAG
GCTCTTTAGTTACAACGGAT -> CTCTTTAGTTACAACGGATG
TGGTCAGATGGACAACTTTT -> GGTCAGATGGACAACTTTTG
TAGGTCTTGGTGACCAACGC -> AGGTCTTGGTGACCAACGCG
AGATAGCTGTATCGAAGTGA -> GATAGCTGTATCGAAGTGAG
CAAAGTAGGGGTGGAGATAG -> AAAGTAGGGGTGGAGATAGA
AGGGACTGGGAAGATAGCTG -> GGGACTGGGAAGATAGCTGT
TTTGCGAAAGGGGACTTACC -> TTGCGAAAGGGGACTTACCT
CGATATTATTTGTGTGATGT -> GATATTATTTGTGTGATGTC
AGAGAGCTTGCCTTGATCTA -> GAGAGCTTGCCTTGATCTAC
CAAGGGGACGACTCAACACA -> AAGGGGACGACTCAACACAC
GCGAAAGGGGACTTACCTCG -> CGAAAGGGGACTTACCTCGT
AACTCTCGAATAACCGAAAG -> ACTCTCGAATAACCGAAAGA
TGAGTTTCAATCTGGTCAGA -> GAGTTTCAATCTGGTCAGAT
GATTTCGCGATGGGTTAGGT -> ATTTCGCGATGGGTTAGGTC
AACCGAAAGAGAGGGACTGG -> ACCGAAAGAGAGGGACTGGG
CGGGTCTAATTTAGGTGTTG -> GGGTCTAATTTAGGTGTTGA
AGTCTGTAATTATCGGGCGG -> GTCTGTAATTATCGGGCGGA
CTGATGAACGGCGCCCGGGT -> TGATGAACGGCGCCCGGGTC
TGGAGATAGATCTCCGGCTA -> GGAGATAGATCTCCGGCTAT
TCAGATGGGTATGTTTTAAA -> CAGATGGGTATGTTTTAAAT
TTTGAGAACTTATATGAGCC -> TTGAGAACTTATATGAGCCC
AGGTAATCCTAGGATGTTGG -> GGTAATCCTAGGATGTTGGA
GTCGACGTCAAGCTCTTTAG -> TCGACGTCAAGCTCTTTAGT
TGACCTGCGACGCCTTTGAG -> GACCTGCGACGCCTTTGAGA
TACAACGGATGCAATGGAGT -> ACAACGGATGCAATGGAGTC
GACGCGTGAGGAACGTTTTG -> ACGCGTGAGGAACGTTTTGT
ATATGAGCCCGCAACACGTT -> TATGAGCCCGCAACACGTTT
GGGTCTAATTTAGGTGTTGA -> GGTCTAATTTAGGTGTTGAT
GGCATGTTGAGTTCCGAACA -> GCATGTTGAGTTCCGAACAT
GTTTTAACAAGGGGACGACT -> TTTTAACAAGGGGACGACTC
TACATGCAGAAGTGTTGAGT -> ACATGCAGAAGTGTTGAGTT
GATCTCCGGCTATGTGGAAA -> ATCTCCGGCTATGTGGAAAT
GGACGCGTGAGGAACGTTTT -> GACGCGTGAGGAACGTTTTG
GCCGACGGCCTTGCTAAGCT -> CCGACGGCCTTGCTAAGCTA
CTCTTTAGTTACAACGGATG -> TCTTTAGTTACAACGGATGC
CCAGCCTACATGCAGAAGTG -> CAGCCTACATGCAGAAGTGT
GTCAAATAGAGGTAACCATA -> TCAAATAGAGGTAACCATAA
TATATGGAACCTGGGCGATT -> ATATGGAACCTGGGCGATTT
TGAACGGCGCCCGGGTCTAA -> GAACGGCGCCCGGGTCTAAT
CACGGGACACGCCTGATGAA -> ACGGGACACGCCTGATGAAC
TGCACATGGACTCAACTCTC -> GCACATGGACTCAACTCTCG
TGGAGTCAAATAGAGGTAAC -> GGAGTCAAATAGAGGTAACC
GCTGGTTCCGCAACCTGACA -> CTGGTTCCGCAACCTGACAG
ATAGAGGTAACCATAAGTAG -> TAGAGGTAACCATAAGTAGC
CCTGATGAACGGCGCCCGGG -> CTGATGAACGGCGCCCGGGT
AAGAGAGGGACTGCGTAAGA -> AGAGAGGGACTGCGTAAGAA
GTGAGTATTCTACTGCTGGT -> TGAGTATTCTACTGCTGGTT
ACCGGATCGGAACCAAGCCT -> CCGGATCGGAACCAAGCCTT
GGATGCAATGGAGTCAAATA -> GATGCAATGGAGTCAAATAG
GACGACTCAACACACCCAGT -> ACGACTCAACACACCCAGTG
GGGACCAGAGACTGTATGGT -> GGACCAGAGACTGTATGGTA
TTGGGGTTTCTAGGTAATCC -> TGGGGTTTCTAGGTAATCCT
CCTGCGACGCCTTTGAGAAC -> CTGCGACGCCTTTGAGAACT
AGCTTGCCTTGATCTACAGC -> GCTTGCCTTGATCTACAGCG
TCAAGCTCTTTAGTTACAAC -> CAAGCTCTTTAGTTACAACG
TTTTATGGCTTAGTTAGAGA -> TTTATGGCTTAGTTAGAGAT
ATCTGGCTCCCCTAGGCGCC -> TCTGGCTCCCCTAGGCGCCA
GTTTCAATCTGGTCAGATGG -> TTTCAATCTGGTCAGATGGA
AACTTGGGGTTTCTAGGTAA -> ACTTGGGGTTTCTAGGTAAT
GAGGCCGACGGCCTTGCTAA -> AGGCCGACGGCCTTGCTAAG
CTTAGGCGCTAACTTTTCAT -> TTAGGCGCTAACTTTTCATG
ATTTAGGTGTTGATCTGTAT -> TTTAGGTGTTGATCTGTATA
GCGCCACCGCATCAGGGACC -> CGCCACCGCATCAGGGACCA
TAGGATGTTGGACCGGATCG -> AGGATGTTGGACCGGATCGG
GGGTTTCTAGGTAATCCTAG -> GGTTTCTAGGTAATCCTAGG
TAAATTCTCTAGCGGCCGAT -> AAATTCTCTAGCGGCCGATA
CAGCTCGACTCCCCCCCCAT -> AGCTCGACTCCCCCCCCATG
CGGAACCAAGCCTTGACTGA -> GGAACCAAGCCTTGACTGAA
CCCATGTCGAATTCTGAAAC -> CCATGTCGAATTCTGAAACT
GGTTTCTAGGTAATCCTAGG -> GTTTCTAGGTAATCCTAGGA
TTAGAGATTCCGAACGACAG -> TAGAGATTCCGAACGACAGT
GCCTACATGCAGAAGTGTTG -> CCTACATGCAGAAGTGTTGA
GAATAACCGAAAGAGAGGGA -> AATAACCGAAAGAGAGGGAC
TCTCCGGCTATGTGGAAATA -> CTCCGGCTATGTGGAAATAC
CGGCAAAGTAGGGGTGGAGA -> GGCAAAGTAGGGGTGGAGAT
TGTCCACGGGACACGCCTGA -> GTCCACGGGACACGCCTGAT
CATAAGTAGCAGGTACCTGA -> ATAAGTAGCAGGTACCTGAA
ATTTCTACAGCTCGACTCCC -> TTTCTACAGCTCGACTCCCC
TGGAACCTGGGCGATTTCGC -> GGAACCTGGGCGATTTCGCG
TAGAGGTAACCATAAGTAGC -> AGAGGTAACCATAAGTAGCA
CTGGTCAGATGGACAACTTT -> TGGTCAGATGGACAACTTTT
ACTCCCCCCCCATGTCGAAT -> CTCCCCCCCCATGTCGAATT
GTGAGAGAGCTTGCCTTGAT -> TGAGAGAGCTTGCCTTGATC
CAGTGAGAGAGCTTGCCTTG -> AGTGAGAGAGCTTGCCTTGA
GTAATTATCGGGCGGACGCG -> TAATTATCGGGCGGACGCGT
TCATGAAAGTTTGCGAAAGG -> CATGAAAGTTTGCGAAAGGG
ATGGACTCAACTCTCGAATA -> TGGACTCAACTCTCGAATAA
ATGGGTTAGGTCTTGGTGAC -> TGGGTTAGGTCTTGGTGACC
GAACCTGGGCGATTTCGCGA -> AACCTGGGCGATTTCGCGAT
GACCGGATCGGAACCAAGCC -> ACCGGATCGGAACCAAGCCT
AAAGTAGGGGTGGAGATAGA -> AAGTAGGGGTGGAGATAGAT
GCCTTGACTGAAGGCAGTGA -> CCTTGACTGAAGGCAGTGAG
AAGCCTTGACTGAAGGCAGT -> AGCCTTGACTGAAGGCAGTG
GGACTGGGAAGATAGCTGTA -> GACTGGGAAGATAGCTGTAT
CTTGACTGAAGGCAGTGAGG -> TTGACTGAAGGCAGTGAGGC
GCATCAGGGACCAGAGACTG -> CATCAGGGACCAGAGACTGT
TCTACAGCGGCTCCCGGCTT -> CTACAGCGGCTCCCGGCTTA
GTGGAGATAGATCTCCGGCT -> TGGAGATAGATCTCCGGCTA
GCCTTGATCTACAGCGGCTC -> CCTTGATCTACAGCGGCTCC
CGATTGCCCTTTGAGGACAT -> GATTGCCCTTTGAGGACATC
GATGTCCACGGGACACGCCT -> ATGTCCACGGGACACGCCTG
TAGAGATTCCGAACGACAGT -> AGAGATTCCGAACGACAGTC
CATGAAAGTTTGCGAAAGGG -> ATGAAAGTTTGCGAAAGGGG
ATGTTTTAAATTCTCTAGCG -> TGTTTTAAATTCTCTAGCGG
CGAATTCTGAAACTATATGG -> GAATTCTGAAACTATATGGA
ATTCTGAAACTATATGGAAC -> TTCTGAAACTATATGGAACC
AGATCTCCGGCTATGTGGAA -> GATCTCCGGCTATGTGGAAA
AACGGCGCCCGGGTCTAATT -> ACGGCGCCCGGGTCTAATTT
TCACGGCAAAGTAGGGGTGG -> CACGGCAAAGTAGGGGTGGA
CTCGACTCCCCCCCCATGTC -> TCGACTCCCCCCCCATGTCG
ATTCCGAACGACAGTCTGTA -> TTCCGAACGACAGTCTGTAA
TCTTTAGTTACAACGGATGC -> CTTTAGTTACAACGGATGCA
GGGACGACTCAACACACCCA -> GGACGACTCAACACACCCAG
AAGCTAATCCACAGGCATGT -> AGCTAATCCACAGGCATGTT
CGGCTCCCGGCTTATCAGAT -> GGCTCCCGGCTTATCAGATG
TAAAAGTCTGCTATTTTCCG -> AAAAGTCTGCTATTTTCCGT
TTAGGCGCTAACTTTTCATG -> TAGGCGCTAACTTTTCATGA
CAATGGAGTCAAATAGAGGT -> AATGGAGTCAAATAGAGGTA
TGGGTATGTTTTAAATTCTC -> GGGTATGTTTTAAATTCTCT
AACAAGGGGACGACTCAACA -> ACAAGGGGACGACTCAACAC
TGCAATGGAGTCAAATAGAG -> GCAATGGAGTCAAATAGAGG
GTCTGTAATTATCGGGCGGA -> TCTGTAATTATCGGGCGGAC
AATCCTAGGATGTTGGACCG -> ATCCTAGGATGTTGGACCGG
TCGGGCGGACGCGTGAGGAA -> CGGGCGGACGCGTGAGGAAC
ACATGGACTCAACTCTCGAA -> CATGGACTCAACTCTCGAAT
AGCCTTGACTGAAGGCAGTG -> GCCTTGACTGAAGGCAGTGA
TGAAAGAGAGGGACTGCGTA -> GAAAGAGAGGGACTGCGTAA
CAAACCAGCCTACATGCAGA -> AAACCAGCCTACATGCAGAA
GGTGACCAACGCGGCTCACG -> GTGACCAACGCGGCTCACGG
GCAACACGTTTTAACAAGGG -> CAACACGTTTTAACAAGGGG
TAGATCTCCGGCTATGTGGA -> AGATCTCCGGCTATGTGGAA
GGGGACTTACCTCGTCGACG -> GGGACTTACCTCGTCGACGT
TTCCGAACATGAGTTTCAAT -> TCCGAACATGAGTTTCAATC
GTCTTAGGCGCTAACTTTTC -> TCTTAGGCGCTAACTTTTCA
TGCAGAAGTGTTGAGTTTGT -> GCAGAAGTGTTGAGTTTGTG
TTCCGCAACCTGACAGCCAA -> TCCGCAACCTGACAGCCAAA
CAGAGACTGTATGGTATGTG -> AGAGACTGTATGGTATGTGC
TATGGAACCTGGGCGATTTC -> ATGGAACCTGGGCGATTTCG
TTGAGGACATCAAACTTGGG -> TGAGGACATCAAACTTGGGG
GGGGTGGAGATAGATCTCCG -> GGGTGGAGATAGATCTCCGG
ATCGAAGTGAGTATTCTACT -> TCGAAGTGAGTATTCTACTG
CATCAAACTTGGGGTTTCTA -> ATCAAACTTGGGGTTTCTAG
TTGAGTTTGTGCCATCTGGC -> TGAGTTTGTGCCATCTGGCT
TTACAACGGATGCAATGGAG -> TACAACGGATGCAATGGAGT
TGTATAAAAGTCTGCTATTT -> GTATAAAAGTCTGCTATTTT
TTTGTCTTAGGCGCTAACTT -> TTGTCTTAGGCGCTAACTTT
TTAACAAGGGGACGACTCAA -> TAACAAGGGGACGACTCAAC
TTACCTCGTCGACGTCAAGC -> TACCTCGTCGACGTCAAGCT
GAGATAGATCTCCGGCTATG -> AGATAGATCTCCGGCTATGT
TGGAAATACAGGTGACCTGC -> GGAAATACAGGTGACCTGCG
TCTAGGTAATCCTAGGATGT -> CTAGGTAATCCTAGGATGTT
CCAGAGACTGTATGGTATGT -> CAGAGACTGTATGGTATGTG
GATTGCCCTTTGAGGACATC -> ATTGCCCTTTGAGGACATCA
ATAACCGAAAGAGAGGGACT -> TAACCGAAAGAGAGGGACTG
CGCAACACGTTTTAACAAGG -> GCAACACGTTTTAACAAGGG
AGTCTGCTATTTTCCGTGCA -> GTCTGCTATTTTCCGTGCAC
AGCGGCTCCCGGCTTATCAG -> GCGGCTCCCGGCTTATCAGA
TTTTCATGAAAGTTTGCGAA -> TTTCATGAAAGTTTGCGAAA
ACCTGGGCGATTTCGCGATG -> CCTGGGCGATTTCGCGATGG
GTATGGTATGTGCCAGTGCG -> TATGGTATGTGCCAGTGCGT
GCCGATATTATTTGTGTGAT -> CCGATATTATTTGTGTGATG
AACCAGCCTACATGCAGAAG -> ACCAGCCTACATGCAGAAGT
GAGTATTCTACTGCTGGTTC -> AGTATTCTACTGCTGGTTCC
GAGCCCGCAACACGTTTTAA -> AGCCCGCAACACGTTTTAAC
TATCAGATGGGTATGTTTTA -> ATCAGATGGGTATGTTTTAA
CGAACATGAGTTTCAATCTG -> GAACATGAGTTTCAATCTGG
ACATGCAGAAGTGTTGAGTT -> CATGCAGAAGTGTTGAGTTT
CTTTTCATGAAAGTTTGCGA -> TTTTCATGAAAGTTTGCGAA
TTTAACAAGGGGACGACTCA -> TTAACAAGGGGACGACTCAA
GCTATGTGGAAATACAGGTG -> CTATGTGGAAATACAGGTGA
CTTGCCTTGATCTACAGCGG -> TTGCCTTGATCTACAGCGGC
GTATAAAAGTCTGCTATTTT -> TATAAAAGTCTGCTATTTTC
CAACTCTCGAATAACCGAAA -> AACTCTCGAATAACCGAAAG
ATCTCCGGCTATGTGGAAAT -> TCTCCGGCTATGTGGAAATA
CAACACACCCAGTGAGAGAG -> AACACACCCAGTGAGAGAGC
TGTTGGACCGGATCGGAACC -> GTTGGACCGGATCGGAACCA
CTGTATAAAAGTCTGCTATT -> TGTATAAAAGTCTGCTATTT
ATCTACAGCGGCTCCCGGCT -> TCTACAGCGGCTCCCGGCTT
TACTGCTGGTTCCGCAACCT -> ACTGCTGGTTCCGCAACCTG
TCCGCAACCTGACAGCCAAA -> CCGCAACCTGACAGCCAAAC
AAGTAGGGGTGGAGATAGAT -> AGTAGGGGTGGAGATAGATC
TTAAATTCTCTAGCGGCCGA -> TAAATTCTCTAGCGGCCGAT
CGTGCACATGGACTCAACTC -> GTGCACATGGACTCAACTCT
CCCAGTGAGAGAGCTTGCCT -> CCAGTGAGAGAGCTTGCCTT
CGGCTTATCAGATGGGTATG -> GGCTTATCAGATGGGTATGT
CCGAACATGAGTTTCAATCT -> CGAACATGAGTTTCAATCTG
GGACCAGAGACTGTATGGTA -> GACCAGAGACTGTATGGTAT
CTTGGGGTTTCTAGGTAATC -> TTGGGGTTTCTAGGTAATCC
GAGGGACTGCGTAAGAATTA -> AGGGACTGCGTAAGAATTAA
GGAAATACAGGTGACCTGCG -> GAAATACAGGTGACCTGCGA
GGCAGTGAGGCCGACGGCCT -> GCAGTGAGGCCGACGGCCTT
GCCCGGGTCTAATTTAGGTG -> CCCGGGTCTAATTTAGGTGT
GGTAACCATAAGTAGCAGGT -> GTAACCATAAGTAGCAGGTA
TCTGTAATTATCGGGCGGAC -> CTGTAATTATCGGGCGGACG
TGAAACTATATGGAACCTGG -> GAAACTATATGGAACCTGGG
GAGAGGGACTGGGAAGATAG -> AGAGGGACTGGGAAGATAGC
CTATTTTCCGTGCACATGGA -> TATTTTCCGTGCACATGGAC
TCAGATGGACAACTTTTGGA -> CAGATGGACAACTTTTGGAT
CCGCAACCTGACAGCCAAAC -> CGCAACCTGACAGCCAAACC
TAATCCACAGGCATGTTGAG -> AATCCACAGGCATGTTGAGT
CGCGATGGGTTAGGTCTTGG -> GCGATGGGTTAGGTCTTGGT
TATGAGCCCGCAACACGTTT -> ATGAGCCCGCAACACGTTTT
GTGGAAATACAGGTGACCTG -> TGGAAATACAGGTGACCTGC
GATATTATTTGTGTGATGTC -> ATATTATTTGTGTGATGTCC
TCCCCTAGGCGCCACCGCAT -> CCCCTAGGCGCCACCGCATC
TGAGAACTTATATGAGCCCG -> GAGAACTTATATGAGCCCGC
TCCGGCTATGTGGAAATACA -> CCGGCTATGTGGAAATACAG
GAATTCTGAAACTATATGGA -> AATTCTGAAACTATATGGAA
TGCGACGCCTTTGAGAACTT -> GCGACGCCTTTGAGAACTTA
AACATGAGTTTCAATCTGGT -> ACATGAGTTTCAATCTGGTC
ACCTGCGACGCCTTTGAGAA -> CCTGCGACGCCTTTGAGAAC
ACGACAGTCTGTAATTATCG -> CGACAGTCTGTAATTATCGG
GAGATTCCGAACGACAGTCT -> AGATTCCGAACGACAGTCTG
TATTATTTGTGTGATGTCCA -> ATTATTTGTGTGATGTCCAC
CATCTGGCTCCCCTAGGCGC -> ATCTGGCTCCCCTAGGCGCC
ATGGCTTAGTTAGAGATTCC -> TGGCTTAGTTAGAGATTCCG
AGAGCTTGCCTTGATCTACA -> GAGCTTGCCTTGATCTACAG
ACTGAAGGCAGTGAGGCCGA -> CTGAAGGCAGTGAGGCCGAC
TGAGGAACGTTTTGTCTTAG -> GAGGAACGTTTTGTCTTAGG
CTGCTATTTTCCGTGCACAT -> TGCTATTTTCCGTGCACATG
CGCCTTTGAGAACTTATATG -> GCCTTTGAGAACTTATATGA
ACAACTTTTGGATTTCTACA -> CAACTTTTGGATTTCTACAG
CGACGCCTTTGAGAACTTAT -> GACGCCTTTGAGAACTTATA
TTCTAGGTAATCCTAGGATG -> TCTAGGTAATCCTAGGATGT
TTAGTTACAACGGATGCAAT -> TAGTTACAACGGATGCAATG
CCTTGATCTACAGCGGCTCC -> CTTGATCTACAGCGGCTCCC
TAACCGAAAGAGAGGGACTG -> AACCGAAAGAGAGGGACTGG
CAAACTTGGGGTTTCTAGGT -> AAACTTGGGGTTTCTAGGTA
TCCCGGCTTATCAGATGGGT -> CCCGGCTTATCAGATGGGTA
AACTTTCGCGGTGTCGATTG -> ACTTTCGCGGTGTCGATTGC
TTCATGAAAGTTTGCGAAAG -> TCATGAAAGTTTGCGAAAGG
ATGAGTTTCAATCTGGTCAG -> TGAGTTTCAATCTGGTCAGA
TGTAATTATCGGGCGGACGC -> GTAATTATCGGGCGGACGCG
TTGATCTACAGCGGCTCCCG -> TGATCTACAGCGGCTCCCGG
TATAAAAGTCTGCTATTTTC -> ATAAAAGTCTGCTATTTTCC
TGTTGAGTTCCGAACATGAG -> GTTGAGTTCCGAACATGAGT
GATTTCTACAGCTCGACTCC -> ATTTCTACAGCTCGACTCCC
GTTTTGTCTTAGGCGCTAAC -> TTTTGTCTTAGGCGCTAACT
GGTGACCTGCGACGCCTTTG -> GTGACCTGCGACGCCTTTGA
CTAGGATGTTGGACCGGATC -> TAGGATGTTGGACCGGATCG
AGTTAGAGATTCCGAACGAC -> GTTAGAGATTCCGAACGACA
ATGTGGAAATACAGGTGACC -> TGTGGAAATACAGGTGACCT
TTTTCCGTGCACATGGACTC -> TTTCCGTGCACATGGACTCA
CGCGTGAGGAACGTTTTGTC -> GCGTGAGGAACGTTTTGTCT
GTCTAATTTAGGTGTTGATC -> TCTAATTTAGGTGTTGATCT
GGCTCACGGCAAAGTAGGGG -> GCTCACGGCAAAGTAGGGGT
GATCTACAGCGGCTCCCGGC -> ATCTACAGCGGCTCCCGGCT
AGAGATTCCGAACGACAGTC -> GAGATTCCGAACGACAGTCT
AGGGGTGGAGATAGATCTCC -> GGGGTGGAGATAGATCTCCG
TACAGCGGCTCCCGGCTTAT -> ACAGCGGCTCCCGGCTTATC
AGGGGACTTACCTCGTCGAC -> GGGGACTTACCTCGTCGACG
ACGGCAAAGTAGGGGTGGAG -> CGGCAAAGTAGGGGTGGAGA
CACGGCAAAGTAGGGGTGGA -> ACGGCAAAGTAGGGGTGGAG
ACCTCGTCGACGTCAAGCTC -> CCTCGTCGACGTCAAGCTCT
GTCTGCTATTTTCCGTGCAC -> TCTGCTATTTTCCGTGCACA
ATGTTGGACCGGATCGGAAC -> TGTTGGACCGGATCGGAACC
GGGACTGCGTAAGAATTAAC -> GGACTGCGTAAGAATTAACT
ATCAGGGACCAGAGACTGTA -> TCAGGGACCAGAGACTGTAT
TGAGTTCCGAACATGAGTTT -> GAGTTCCGAACATGAGTTTC
CGACGTCAAGCTCTTTAGTT -> GACGTCAAGCTCTTTAGTTA
ACGGCGCCCGGGTCTAATTT -> CGGCGCCCGGGTCTAATTTA
CAGTCTGTAATTATCGGGCG -> AGTCTGTAATTATCGGGCGG
GCAATGGAGTCAAATAGAGG -> CAATGGAGTCAAATAGAGGT
GGGACTGGGAAGATAGCTGT -> GGACTGGGAAGATAGCTGTA
CGAAAGGGGACTTACCTCGT -> GAAAGGGGACTTACCTCGTC
GTAAGAATTAACTTTCGCGG -> TAAGAATTAACTTTCGCGGT
CGGCTATGTGGAAATACAGG -> GGCTATGTGGAAATACAGGT
TAAGTAGCAGGTACCTGAAA -> AAGTAGCAGGTACCTGAAAG
GGTCTAATTTAGGTGTTGAT -> GTCTAATTTAGGTGTTGATC
TATGTTTTAAATTCTCTAGC -> ATGTTTTAAATTCTCTAGCG
GTTGATCTGTATAAAAGTCT -> TTGATCTGTATAAAAGTCTG
TCAACTCTCGAATAACCGAA -> CAACTCTCGAATAACCGAAA
ATGAGCCCGCAACACGTTTT -> TGAGCCCGCAACACGTTTTA
TTATCAGATGGGTATGTTTT -> TATCAGATGGGTATGTTTTA
CGTGAGGAACGTTTTGTCTT -> GTGAGGAACGTTTTGTCTTA
CCGAAAGAGAGGGACTGGGA -> CGAAAGAGAGGGACTGGGAA
GACTCAACACACCCAGTGAG -> ACTCAACACACCCAGTGAGA
ATAGATCTCCGGCTATGTGG -> TAGATCTCCGGCTATGTGGA
GAACCAAGCCTTGACTGAAG -> AACCAAGCCTTGACTGAAGG
TTGTGCCATCTGGCTCCCCT -> TGTGCCATCTGGCTCCCCTA
GGCTTATCAGATGGGTATGT -> GCTTATCAGATGGGTATGTT
TGGCTCCCCTAGGCGCCACC -> GGCTCCCCTAGGCGCCACCG
AGTATTCTACTGCTGGTTCC -> GTATTCTACTGCTGGTTCCG
GGATTTCTACAGCTCGACTC -> GATTTCTACAGCTCGACTCC
CGGTGTCGATTGCCCTTTGA -> GGTGTCGATTGCCCTTTGAG
CTAATCCACAGGCATGTTGA -> TAATCCACAGGCATGTTGAG
GGGACACGCCTGATGAACGG -> GGACACGCCTGATGAACGGC
TGATCTGTATAAAAGTCTGC -> GATCTGTATAAAAGTCTGCT
TCCACGGGACACGCCTGATG -> CCACGGGACACGCCTGATGA
CCACAGGCATGTTGAGTTCC -> CACAGGCATGTTGAGTTCCG
CATGGACTCAACTCTCGAAT -> ATGGACTCAACTCTCGAATA
GTCGAATTCTGAAACTATAT -> TCGAATTCTGAAACTATATG
GCTCGACTCCCCCCCCATGT -> CTCGACTCCCCCCCCATGTC
TCGCGATGGGTTAGGTCTTG -> CGCGATGGGTTAGGTCTTGG
TTGAGAACTTATATGAGCCC -> TGAGAACTTATATGAGCCCG
GGACATCAAACTTGGGGTTT -> GACATCAAACTTGGGGTTTC
GAGACTGTATGGTATGTGCC -> AGACTGTATGGTATGTGCCA
AAGAATTAACTTTCGCGGTG -> AGAATTAACTTTCGCGGTGT
CAAATAGAGGTAACCATAAG -> AAATAGAGGTAACCATAAGT
GTTGAGTTCCGAACATGAGT -> TTGAGTTCCGAACATGAGTT
AGGGACTGCGTAAGAATTAA -> GGGACTGCGTAAGAATTAAC
GCCACCGCATCAGGGACCAG -> CCACCGCATCAGGGACCAGA
ATGAAAGTTTGCGAAAGGGG -> TGAAAGTTTGCGAAAGGGGA
CCGGGTCTAATTTAGGTGTT -> CGGGTCTAATTTAGGTGTTG
ATGGAGTCAAATAGAGGTAA -> TGGAGTCAAATAGAGGTAAC
GTGACCAACGCGGCTCACGG -> TGACCAACGCGGCTCACGGC
TAGGTAATCCTAGGATGTTG -> AGGTAATCCTAGGATGTTGG
TAACAAGGGGACGACTCAAC -> AACAAGGGGACGACTCAACA
TGAGAGAGCTTGCCTTGATC -> GAGAGAGCTTGCCTTGATCT
CACCATTTTATGGCTTAGTT -> ACCATTTTATGGCTTAGTTA
TTATGGCTTAGTTAGAGATT -> TATGGCTTAGTTAGAGATTC
CGCTAACTTTTCATGAAAGT -> GCTAACTTTTCATGAAAGTT
GCATGTTGAGTTCCGAACAT -> CATGTTGAGTTCCGAACATG
TCAGGGACCAGAGACTGTAT -> CAGGGACCAGAGACTGTATG
TAACTTTCGCGGTGTCGATT -> AACTTTCGCGGTGTCGATTG
ATGGACAACTTTTGGATTTC -> TGGACAACTTTTGGATTTCT
GCCAAACCAGCCTACATGCA -> CCAAACCAGCCTACATGCAG
TTTCATGAAAGTTTGCGAAA -> TTCATGAAAGTTTGCGAAAG
GGACACGCCTGATGAACGGC -> GACACGCCTGATGAACGGCG
GAGTTCCGAACATGAGTTTC -> AGTTCCGAACATGAGTTTCA
CGGCCGATATTATTTGTGTG -> GGCCGATATTATTTGTGTGA
CATGTCGAATTCTGAAACTA -> ATGTCGAATTCTGAAACTAT
CCTACATGCAGAAGTGTTGA -> CTACATGCAGAAGTGTTGAG
TGACTGAAGGCAGTGAGGCC -> GACTGAAGGCAGTGAGGCCG
TTTAGTTACAACGGATGCAA -> TTAGTTACAACGGATGCAAT
CTCGAATAACCGAAAGAGAG -> TCGAATAACCGAAAGAGAGG
GATGGGTATGTTTTAAATTC -> ATGGGTATGTTTTAAATTCT
ACTCTCGAATAACCGAAAGA -> CTCTCGAATAACCGAAAGAG
AGGACATCAAACTTGGGGTT -> GGACATCAAACTTGGGGTTT
ACAGGTGACCTGCGACGCCT -> CAGGTGACCTGCGACGCCTT
TGGACTCAACTCTCGAATAA -> GGACTCAACTCTCGAATAAC
GTGAGGAACGTTTTGTCTTA -> TGAGGAACGTTTTGTCTTAG
AGGCCGACGGCCTTGCTAAG -> GGCCGACGGCCTTGCTAAGC
TTGAGTTCCGAACATGAGTT -> TGAGTTCCGAACATGAGTTT
ACGCCTTTGAGAACTTATAT -> CGCCTTTGAGAACTTATATG
TTCCGAACGACAGTCTGTAA -> TCCGAACGACAGTCTGTAAT
GCTAACTTTTCATGAAAGTT -> CTAACTTTTCATGAAAGTTT
AGTAGGGGTGGAGATAGATC -> GTAGGGGTGGAGATAGATCT
CAATCTGGTCAGATGGACAA -> AATCTGGTCAGATGGACAAC
ACTGGGAAGATAGCTGTATC -> CTGGGAAGATAGCTGTATCG
ATTGCCCTTTGAGGACATCA -> TTGCCCTTTGAGGACATCAA
TGTGATGTCCACGGGACACG -> GTGATGTCCACGGGACACGC
GAGAGAGCTTGCCTTGATCT -> AGAGAGCTTGCCTTGATCTA
TATGGTATGTGCCAGTGCGT -> ATGGTATGTGCCAGTGCGTA
AGAGGTAACCATAAGTAGCA -> GAGGTAACCATAAGTAGCAG
TGTGTGATGTCCACGGGACA -> GTGTGATGTCCACGGGACAC
ATAAAAGTCTGCTATTTTCC -> TAAAAGTCTGCTATTTTCCG
GGCCGACGGCCTTGCTAAGC -> GCCGACGGCCTTGCTAAGCT
AATCCACAGGCATGTTGAGT -> ATCCACAGGCATGTTGAGTT
ATACAGGTGACCTGCGACGC -> TACAGGTGACCTGCGACGCC
TGACCAACGCGGCTCACGGC -> GACCAACGCGGCTCACGGCA
CCCGGGTCTAATTTAGGTGT -> CCGGGTCTAATTTAGGTGTT
GTGTGATGTCCACGGGACAC -> TGTGATGTCCACGGGACACG
CACCGCATCAGGGACCAGAG -> ACCGCATCAGGGACCAGAGA
GATAGATCTCCGGCTATGTG -> ATAGATCTCCGGCTATGTGG
CCTTTGAGGACATCAAACTT -> CTTTGAGGACATCAAACTTG
TCGCGGTGTCGATTGCCCTT -> CGCGGTGTCGATTGCCCTTT
TCTCTAGCGGCCGATATTAT -> CTCTAGCGGCCGATATTATT
ACAGCGGCTCCCGGCTTATC -> CAGCGGCTCCCGGCTTATCA
GAGAGGGACTGCGTAAGAAT -> AGAGGGACTGCGTAAGAATT
CGCGGTGTCGATTGCCCTTT -> GCGGTGTCGATTGCCCTTTG
GAAAGAGAGGGACTGGGAAG -> AAAGAGAGGGACTGGGAAGA
ATGTTGAGTTCCGAACATGA -> TGTTGAGTTCCGAACATGAG
CCTCGTCGACGTCAAGCTCT -> CTCGTCGACGTCAAGCTCTT
TGTTGAGTTTGTGCCATCTG -> GTTGAGTTTGTGCCATCTGG
CTACAGCGGCTCCCGGCTTA -> TACAGCGGCTCCCGGCTTAT
TATCGAAGTGAGTATTCTAC -> ATCGAAGTGAGTATTCTACT
CGTCGACGTCAAGCTCTTTA -> GTCGACGTCAAGCTCTTTAG
CTGTAATTATCGGGCGGACG -> TGTAATTATCGGGCGGACGC
GACGCCTTTGAGAACTTATA -> ACGCCTTTGAGAACTTATAT
ACGTTTTGTCTTAGGCGCTA -> CGTTTTGTCTTAGGCGCTAA
AATTTAGGTGTTGATCTGTA -> ATTTAGGTGTTGATCTGTAT
CAGGCATGTTGAGTTCCGAA -> AGGCATGTTGAGTTCCGAAC
CTCCCCTAGGCGCCACCGCA -> TCCCCTAGGCGCCACCGCAT
GGAACGTTTTGTCTTAGGCG -> GAACGTTTTGTCTTAGGCGC
ATCTGGTCAGATGGACAACT -> TCTGGTCAGATGGACAACTT
GGACTCAACTCTCGAATAAC -> GACTCAACTCTCGAATAACC
CCCGCAACACGTTTTAACAA -> CCGCAACACGTTTTAACAAG
CAACGCGGCTCACGGCAAAG -> AACGCGGCTCACGGCAAAGT
TCCGAACATGAGTTTCAATC -> CCGAACATGAGTTTCAATCT
CTAGGCGCCACCGCATCAGG -> TAGGCGCCACCGCATCAGGG
CGGCCTTGCTAAGCTAATCC -> GGCCTTGCTAAGCTAATCCA
GAGGAACGTTTTGTCTTAGG -> AGGAACGTTTTGTCTTAGGC
TTTCCGTGCACATGGACTCA -> TTCCGTGCACATGGACTCAA
TCTTAGGCGCTAACTTTTCA -> CTTAGGCGCTAACTTTTCAT
AACGGATGCAATGGAGTCAA -> ACGGATGCAATGGAGTCAAA
GGAGATAGATCTCCGGCTAT -> GAGATAGATCTCCGGCTATG
CTTGATCTACAGCGGCTCCC -> TTGATCTACAGCGGCTCCCG
TGTCTTAGGCGCTAACTTTT -> GTCTTAGGCGCTAACTTTTC
CGCATCAGGGACCAGAGACT -> GCATCAGGGACCAGAGACTG
TAATCCTAGGATGTTGGACC -> AATCCTAGGATGTTGGACCG
TATCGGGCGGACGCGTGAGG -> ATCGGGCGGACGCGTGAGGA
TTTCAATCTGGTCAGATGGA -> TTCAATCTGGTCAGATGGAC
AACCTGGGCGATTTCGCGAT -> ACCTGGGCGATTTCGCGATG
CCTAGGCGCCACCGCATCAG -> CTAGGCGCCACCGCATCAGG
TAAGAATTAACTTTCGCGGT -> AAGAATTAACTTTCGCGGTG
GTATTCTACTGCTGGTTCCG -> TATTCTACTGCTGGTTCCGC
GATTCCGAACGACAGTCTGT -> ATTCCGAACGACAGTCTGTA
GGGGTTTCTAGGTAATCCTA -> GGGTTTCTAGGTAATCCTAG
TGCCATCTGGCTCCCCTAGG -> GCCATCTGGCTCCCCTAGGC
ATTAACTTTCGCGGTGTCGA -> TTAACTTTCGCGGTGTCGAT
CAAGCCTTGACTGAAGGCAG -> AAGCCTTGACTGAAGGCAGT
TGGTATGTGCCAGTGCGTAT -> GGTATGTGCCAGTGCGTATA
CAACGGATGCAATGGAGTCA -> AACGGATGCAATGGAGTCAA
CTTGCTAAGCTAATCCACAG -> TTGCTAAGCTAATCCACAGG
CGAACGACAGTCTGTAATTA -> GAACGACAGTCTGTAATTAT
GAAATACAGGTGACCTGCGA -> AAATACAGGTGACCTGCGAC
ACGACTCAACACACCCAGTG -> CGACTCAACACACCCAGTGA
CTTTTGGATTTCTACAGCTC -> TTTTGGATTTCTACAGCTCG
TTTCTAGGTAATCCTAGGAT -> TTCTAGGTAATCCTAGGATG
AAATAGAGGTAACCATAAGT -> AATAGAGGTAACCATAAGTA
TGGGAAGATAGCTGTATCGA -> GGGAAGATAGCTGTATCGAA
GGTGTTGATCTGTATAAAAG -> GTGTTGATCTGTATAAAAGT
TTTGAGGACATCAAACTTGG -> TTGAGGACATCAAACTTGGG
TTTTGTCTTAGGCGCTAACT -> TTTGTCTTAGGCGCTAACTT
AAGTCTGCTATTTTCCGTGC -> AGTCTGCTATTTTCCGTGCA
GCTCCCCTAGGCGCCACCGC -> CTCCCCTAGGCGCCACCGCA
GAGGGACTGGGAAGATAGCT -> AGGGACTGGGAAGATAGCTG
CTGCTGGTTCCGCAACCTGA -> TGCTGGTTCCGCAACCTGAC
CTTGGTGACCAACGCGGCTC -> TTGGTGACCAACGCGGCTCA
ACTTGGGGTTTCTAGGTAAT -> CTTGGGGTTTCTAGGTAATC
GACTGTATGGTATGTGCCAG -> ACTGTATGGTATGTGCCAGT
CGACTCCCCCCCCATGTCGA -> GACTCCCCCCCCATGTCGAA
TCCCCCCCCATGTCGAATTC -> CCCCCCCCATGTCGAATTCT
GTCAAGCTCTTTAGTTACAA -> TCAAGCTCTTTAGTTACAAC
GGCGCCACCGCATCAGGGAC -> GCGCCACCGCATCAGGGACC
ACGTTTTAACAAGGGGACGA -> CGTTTTAACAAGGGGACGAC
CCCGGCTTATCAGATGGGTA -> CCGGCTTATCAGATGGGTAT
TAACTTTTCATGAAAGTTTG -> AACTTTTCATGAAAGTTTGC
TGAGGCCGACGGCCTTGCTA -> GAGGCCGACGGCCTTGCTAA
GACAACTTTTGGATTTCTAC -> ACAACTTTTGGATTTCTACA
ACTGCGTAAGAATTAACTTT -> CTGCGTAAGAATTAACTTTC
TGAGTATTCTACTGCTGGTT -> GAGTATTCTACTGCTGGTTC
AGAGAGGGACTGCGTAAGAA -> GAGAGGGACTGCGTAAGAAT
TTTATGGCTTAGTTAGAGAT -> TTATGGCTTAGTTAGAGATT
CTCCCGGCTTATCAGATGGG -> TCCCGGCTTATCAGATGGGT
GAGTCAAATAGAGGTAACCA -> AGTCAAATAGAGGTAACCAT
AACTTATATGAGCCCGCAAC -> ACTTATATGAGCCCGCAACA
TTATTTGTGTGATGTCCACG -> TATTTGTGTGATGTCCACGG
GATGTTGGACCGGATCGGAA -> ATGTTGGACCGGATCGGAAC
TCAATCTGGTCAGATGGACA -> CAATCTGGTCAGATGGACAA
GCACATGGACTCAACTCTCG -> CACATGGACTCAACTCTCGA
TAGCTGTATCGAAGTGAGTA -> AGCTGTATCGAAGTGAGTAT
CGGATGCAATGGAGTCAAAT -> GGATGCAATGGAGTCAAATA
GTGTTGATCTGTATAAAAGT -> TGTTGATCTGTATAAAAGTC
CACATGGACTCAACTCTCGA -> ACATGGACTCAACTCTCGAA
TGGGTTAGGTCTTGGTGACC -> GGGTTAGGTCTTGGTGACCA
TGTGGAAATACAGGTGACCT -> GTGGAAATACAGGTGACCTG
GGTATGTTTTAAATTCTCTA -> GTATGTTTTAAATTCTCTAG
TCGAATAACCGAAAGAGAGG -> CGAATAACCGAAAGAGAGGG
CTGGGCGATTTCGCGATGGG -> TGGGCGATTTCGCGATGGGT
GGAACCAAGCCTTGACTGAA -> GAACCAAGCCTTGACTGAAG
AATAGAGGTAACCATAAGTA -> ATAGAGGTAACCATAAGTAG
ATTATTTGTGTGATGTCCAC -> TTATTTGTGTGATGTCCACG
GGGGACGACTCAACACACCC -> GGGACGACTCAACACACCCA
GCGCCCGGGTCTAATTTAGG -> CGCCCGGGTCTAATTTAGGT
AGGATGTTGGACCGGATCGG -> GGATGTTGGACCGGATCGGA
TTTTAAATTCTCTAGCGGCC -> TTTAAATTCTCTAGCGGCCG
TCTAGCGGCCGATATTATTT -> CTAGCGGCCGATATTATTTG
TTCTACAGCTCGACTCCCCC -> TCTACAGCTCGACTCCCCCC
GCCCGCAACACGTTTTAACA -> CCCGCAACACGTTTTAACAA
TAGGGGTGGAGATAGATCTC -> AGGGGTGGAGATAGATCTCC
ACTGCTGGTTCCGCAACCTG -> CTGCTGGTTCCGCAACCTGA
GGCTATGTGGAAATACAGGT -> GCTATGTGGAAATACAGGTG
CATTTTATGGCTTAGTTAGA -> ATTTTATGGCTTAGTTAGAG
TAGGCGCTAACTTTTCATGA -> AGGCGCTAACTTTTCATGAA
ACTTATATGAGCCCGCAACA -> CTTATATGAGCCCGCAACAC
AGCGGCCGATATTATTTGTG -> GCGGCCGATATTATTTGTGT
GTGCCATCTGGCTCCCCTAG -> TGCCATCTGGCTCCCCTAGG
CCGAACGACAGTCTGTAATT -> CGAACGACAGTCTGTAATTA
CCCTTTGAGGACATCAAACT -> CCTTTGAGGACATCAAACTT
AGGTAACCATAAGTAGCAGG -> GGTAACCATAAGTAGCAGGT
TTGGACCGGATCGGAACCAA -> TGGACCGGATCGGAACCAAG
GGTTAGGTCTTGGTGACCAA -> GTTAGGTCTTGGTGACCAAC
TCGATTGCCCTTTGAGGACA -> CGATTGCCCTTTGAGGACAT
AGAGAGGGACTGGGAAGATA -> GAGAGGGACTGGGAAGATAG
TTTTAACAAGGGGACGACTC -> TTTAACAAGGGGACGACTCA
CCGATATTATTTGTGTGATG -> CGATATTATTTGTGTGATGT
TTAGGTGTTGATCTGTATAA -> TAGGTGTTGATCTGTATAAA
ATGGAACCTGGGCGATTTCG -> TGGAACCTGGGCGATTTCGC
CGAAGTGAGTATTCTACTGC -> GAAGTGAGTATTCTACTGCT
CCGTGCACATGGACTCAACT -> CGTGCACATGGACTCAACTC
GAAAGGGGACTTACCTCGTC -> AAAGGGGACTTACCTCGTCG
CTGGGAAGATAGCTGTATCG -> TGGGAAGATAGCTGTATCGA
TGGGCGATTTCGCGATGGGT -> GGGCGATTTCGCGATGGGTT
TTTAAATTCTCTAGCGGCCG -> TTAAATTCTCTAGCGGCCGA
TGAGCCCGCAACACGTTTTA -> GAGCCCGCAACACGTTTTAA
CCGCAACACGTTTTAACAAG -> CGCAACACGTTTTAACAAGG
GCCTGATGAACGGCGCCCGG -> CCTGATGAACGGCGCCCGGG
ATCGGAACCAAGCCTTGACT -> TCGGAACCAAGCCTTGACTG
CTGAAGGCAGTGAGGCCGAC -> TGAAGGCAGTGAGGCCGACG
GACATCAAACTTGGGGTTTC -> ACATCAAACTTGGGGTTTCT
GACGTCAAGCTCTTTAGTTA -> ACGTCAAGCTCTTTAGTTAC
TGGGGTTTCTAGGTAATCCT -> GGGGTTTCTAGGTAATCCTA
ACCAGCCTACATGCAGAAGT -> CCAGCCTACATGCAGAAGTG
TTATATGAGCCCGCAACACG -> TATATGAGCCCGCAACACGT
ACGCGGCTCACGGCAAAGTA -> CGCGGCTCACGGCAAAGTAG
GTATCGAAGTGAGTATTCTA -> TATCGAAGTGAGTATTCTAC
TCTGGCTCCCCTAGGCGCCA -> CTGGCTCCCCTAGGCGCCAC
ACGGCCTTGCTAAGCTAATC -> CGGCCTTGCTAAGCTAATCC
GACGGCCTTGCTAAGCTAAT -> ACGGCCTTGCTAAGCTAATC
GCGCTAACTTTTCATGAAAG -> CGCTAACTTTTCATGAAAGT
CTGACAGCCAAACCAGCCTA -> TGACAGCCAAACCAGCCTAC
AGGGACCAGAGACTGTATGG -> GGGACCAGAGACTGTATGGT
GAACGGCGCCCGGGTCTAAT -> AACGGCGCCCGGGTCTAATT
AGGTGACCTGCGACGCCTTT -> GGTGACCTGCGACGCCTTTG
GTTGGACCGGATCGGAACCA -> TTGGACCGGATCGGAACCAA
CTACAGCTCGACTCCCCCCC -> TACAGCTCGACTCCCCCCCC
AATTAACTTTCGCGGTGTCG -> ATTAACTTTCGCGGTGTCGA
CTTATCAGATGGGTATGTTT -> TTATCAGATGGGTATGTTTT
AGATAGATCTCCGGCTATGT -> GATAGATCTCCGGCTATGTG
GTCAGATGGACAACTTTTGG -> TCAGATGGACAACTTTTGGA
TCTACTGCTGGTTCCGCAAC -> CTACTGCTGGTTCCGCAACC
ATGTCCACGGGACACGCCTG -> TGTCCACGGGACACGCCTGA
GAAGATAGCTGTATCGAAGT -> AAGATAGCTGTATCGAAGTG
TGATGTCCACGGGACACGCC -> GATGTCCACGGGACACGCCT
GCTATTTTCCGTGCACATGG -> CTATTTTCCGTGCACATGGA
ACCATAAGTAGCAGGTACCT -> CCATAAGTAGCAGGTACCTG
TCCGAACGACAGTCTGTAAT -> CCGAACGACAGTCTGTAATT
CGGGCGGACGCGTGAGGAAC -> GGGCGGACGCGTGAGGAACG
TCTCGAATAACCGAAAGAGA -> CTCGAATAACCGAAAGAGAG
TTATCGGGCGGACGCGTGAG -> TATCGGGCGGACGCGTGAGG
ATCCACAGGCATGTTGAGTT -> TCCACAGGCATGTTGAGTTC
CTATGTGGAAATACAGGTGA -> TATGTGGAAATACAGGTGAC
CGACAGTCTGTAATTATCGG -> GACAGTCTGTAATTATCGGG
AGTGTTGAGTTTGTGCCATC -> GTGTTGAGTTTGTGCCATCT
CATGTTGAGTTCCGAACATG -> ATGTTGAGTTCCGAACATGA
CAGATGGGTATGTTTTAAAT -> AGATGGGTATGTTTTAAATT
GACTCCCCCCCCATGTCGAA -> ACTCCCCCCCCATGTCGAAT
TATGTGGAAATACAGGTGAC -> ATGTGGAAATACAGGTGACC
GGCGCCCGGGTCTAATTTAG -> GCGCCCGGGTCTAATTTAGG
TACAGCTCGACTCCCCCCCC -> ACAGCTCGACTCCCCCCCCA
ACTATATGGAACCTGGGCGA -> CTATATGGAACCTGGGCGAT
TTGCTAAGCTAATCCACAGG -> TGCTAAGCTAATCCACAGGC
GATGGGTTAGGTCTTGGTGA -> ATGGGTTAGGTCTTGGTGAC
CTGTATGGTATGTGCCAGTG -> TGTATGGTATGTGCCAGTGC
GCAAAGTAGGGGTGGAGATA -> CAAAGTAGGGGTGGAGATAG
TGTCGAATTCTGAAACTATA -> GTCGAATTCTGAAACTATAT
GAAGGCAGTGAGGCCGACGG -> AAGGCAGTGAGGCCGACGGC
GCAGAAGTGTTGAGTTTGTG -> CAGAAGTGTTGAGTTTGTGC
GAAAGAGAGGGACTGCGTAA -> AAAGAGAGGGACTGCGTAAG
TTTAGGTGTTGATCTGTATA -> TTAGGTGTTGATCTGTATAA
TGATCTACAGCGGCTCCCGG -> GATCTACAGCGGCTCCCGGC
CAGCCTACATGCAGAAGTGT -> AGCCTACATGCAGAAGTGTT
ACTTTCGCGGTGTCGATTGC -> CTTTCGCGGTGTCGATTGCC
GCTTGCCTTGATCTACAGCG -> CTTGCCTTGATCTACAGCGG
AGTTACAACGGATGCAATGG -> GTTACAACGGATGCAATGGA
GAGCTTGCCTTGATCTACAG -> AGCTTGCCTTGATCTACAGC
GCTTAGTTAGAGATTCCGAA -> CTTAGTTAGAGATTCCGAAC
AAGGCAGTGAGGCCGACGGC -> AGGCAGTGAGGCCGACGGCC
AGAAGTGTTGAGTTTGTGCC -> GAAGTGTTGAGTTTGTGCCA
TGAGGACATCAAACTTGGGG -> GAGGACATCAAACTTGGGGT
AATACAGGTGACCTGCGACG -> ATACAGGTGACCTGCGACGC
GATGCAATGGAGTCAAATAG -> ATGCAATGGAGTCAAATAGA
AACCATAAGTAGCAGGTACC -> ACCATAAGTAGCAGGTACCT
CACAGGCATGTTGAGTTCCG -> ACAGGCATGTTGAGTTCCGA
AGTTCCGAACATGAGTTTCA -> GTTCCGAACATGAGTTTCAA
TGGCTTAGTTAGAGATTCCG -> GGCTTAGTTAGAGATTCCGA
TAGGTGTTGATCTGTATAAA -> AGGTGTTGATCTGTATAAAA
ATATTATTTGTGTGATGTCC -> TATTATTTGTGTGATGTCCA
CGGGACACGCCTGATGAACG -> GGGACACGCCTGATGAACGG
CTGGCTCCCCTAGGCGCCAC -> TGGCTCCCCTAGGCGCCACC
TCCACAGGCATGTTGAGTTC -> CCACAGGCATGTTGAGTTCC
AGGCATGTTGAGTTCCGAAC -> GGCATGTTGAGTTCCGAACA
TTTCGCGGTGTCGATTGCCC -> TTCGCGGTGTCGATTGCCCT
TGCTGGTTCCGCAACCTGAC -> GCTGGTTCCGCAACCTGACA
ACAACGGATGCAATGGAGTC -> CAACGGATGCAATGGAGTCA
TTCTGAAACTATATGGAACC -> TCTGAAACTATATGGAACCT
GGCCTTGCTAAGCTAATCCA -> GCCTTGCTAAGCTAATCCAC
TCCGTGCACATGGACTCAAC -> CCGTGCACATGGACTCAACT
GTTACAACGGATGCAATGGA -> TTACAACGGATGCAATGGAG
