GTACCACTGAGATATACTG -> TACCACTGAGATATACTGA
GGGTACATTATCGATTCGC -> GGTACATTATCGATTCGCA
CTGCTCAGCACCTGGAGTA -> TGCTCAGCACCTGGAGTAC
AACGGGATGAAGGTCGGTT -> ACGGGATGAAGGTCGGTTA
TGCATCCACAATCGTCGTG -> GCATCCACAATCGTCGTGC
CTGTAGCGTCCTTATTATC -> TGTAGCGTCCTTATTATCC
TTAACCTGGGACGTCCTTA -> TAACCTGGGACGTCCTTAT
GCATCCTCGGTTGAAACGA -> CATCCTCGGTTGAAACGAA
CCCCTGGCAAACAACCGGA -> CCCTGGCAAACAACCGGAG
CCATCGACAGTGCTGCAGC -> CATCGACAGTGCTGCAGCA
TTCTGAAGCATGTATAGGC -> TCTGAAGCATGTATAGGCT
GACCTAGTCGTCCTTATTA -> ACCTAGTCGTCCTTATTAT
TCCATGCTCGTCAAGTTGG -> CCATGCTCGTCAAGTTGGG
TCACACTGGCTGGGGAAAG -> CACACTGGCTGGGGAAAGC
ATTCGTGCGTAACCCCCCC -> TTCGTGCGTAACCCCCCCT
CCTGCCCGGCCACGACCGC -> CTGCCCGGCCACGACCGCG
TGCGCCTTGTAGGGTCGCC -> GCGCCTTGTAGGGTCGCCG
GGGTCTGGTGGCCGGTAAA -> GGTCTGGTGGCCGGTAAAA
GTCAAGTTGGGGCACAGCT -> TCAAGTTGGGGCACAGCTG
AATCACTCCATTACGCCAA -> ATCACTCCATTACGCCAAG
CATCGACAGTGCTGCAGCA -> ATCGACAGTGCTGCAGCAG
ATGGTTATGTCCATCGTAA -> TGGTTATGTCCATCGTAAC
TACCCGGTTATGTTGTCAC -> ACCCGGTTATGTTGTCACC
GGACGGAATCCTACAATCC -> GACGGAATCCTACAATCCC
TACCTTCCAGCCTGTCCCC -> ACCTTCCAGCCTGTCCCCT
CGGAGGTTCAAGTATTCGG -> GGAGGTTCAAGTATTCGGG
GGTCTGGTGGCCGGTAAAA -> GTCTGGTGGCCGGTAAAAA
TCACGCGAGACAGTGAGTG -> CACGCGAGACAGTGAGTGC
AGTGAACATATGGACGGAA -> GTGAACATATGGACGGAAA
AGGCTCCCTTAGACAGTTT -> GGCTCCCTTAGACAGTTTC
GTGGACGGAATCCTACAAT -> TGGACGGAATCCTACAATC
GCGATATACAAGGATAGCT -> CGATATACAAGGATAGCTC
AAAATGAAGAGGTTTTTGT -> AAATGAAGAGGTTTTTGTA
AAAACAGCGTCCTGGATAC -> AAACAGCGTCCTGGATACT
CTGCCAAAGCCCAACCGTC -> TGCCAAAGCCCAACCGTCA
CTGCGCCTTGTAGGGTCGC -> TGCGCCTTGTAGGGTCGCC
TTACGGTCATAACATGGCA -> TACGGTCATAACATGGCAA
TGAAACGAATGGAGAGGCG -> GAAACGAATGGAGAGGCGC
TCCCGGGTACATTATCGAT -> CCCGGGTACATTATCGATT
ATAGATCACGCGAGACAGT -> TAGATCACGCGAGACAGTG
TCCTTATTATCCTGCTCAG -> CCTTATTATCCTGCTCAGC
CTCTGAGAGATTCTATTGA -> TCTGAGAGATTCTATTGAA
CCGCCGACTTAGGTTGGTA -> CGCCGACTTAGGTTGGTAT
CAAGAGACTATCTTCACTC -> AAGAGACTATCTTCACTCG
ACAAGGATAGCTCGGAGCT -> CAAGGATAGCTCGGAGCTC
GAGAGCTAGATTCAGGCTG -> AGAGCTAGATTCAGGCTGT
CTCCCTCGCCCTCAGTGTA -> TCCCTCGCCCTCAGTGTAT
CTGTTACTCCCGGGTACAT -> TGTTACTCCCGGGTACATT
GTAGCGTGGCTTACTGCGC -> TAGCGTGGCTTACTGCGCC
AAGGAGCGTGTTACGGTCA -> AGGAGCGTGTTACGGTCAT
GGTATGTAAGAGAGCTAGA -> GTATGTAAGAGAGCTAGAT
CCTTAGACAGTTTCAGTCG -> CTTAGACAGTTTCAGTCGT
CGAGTTGCCGGCTGATAAG -> GAGTTGCCGGCTGATAAGT
AGCTGACTCGAGTTGCCGG -> GCTGACTCGAGTTGCCGGC
AACCCAGGTGTTACCACAG -> ACCCAGGTGTTACCACAGA
CTGACGACAACGTATAGTC -> TGACGACAACGTATAGTCG
CGGGTCTGGTGGCCGGTAA -> GGGTCTGGTGGCCGGTAAA
AATATTGTCATAGGTGTGT -> ATATTGTCATAGGTGTGTA
GGGCTAACCATGTGAGGGC -> GGCTAACCATGTGAGGGCA
GTCGCCGGGCTTGATTACC -> TCGCCGGGCTTGATTACCG
TATCGACGTTGCTTCCCTC -> ATCGACGTTGCTTCCCTCC
CCTGCTCAGCACCTGGAGT -> CTGCTCAGCACCTGGAGTA
TGATTACCGAGTAAGTCAG -> GATTACCGAGTAAGTCAGT
TTCAGGCTGTGCTCCCTCG -> TCAGGCTGTGCTCCCTCGC
GGTGTGCCGCGACTAAAGC -> GTGTGCCGCGACTAAAGCG
GTCACGAACGATTTAAAAG -> TCACGAACGATTTAAAAGA
ATGTTGTCACCACATGCAT -> TGTTGTCACCACATGCATC
TCTATTGAAAATACCTAGA -> CTATTGAAAATACCTAGAA
TCCTGCTCAGCACCTGGAG -> CCTGCTCAGCACCTGGAGT
GGGGTCCTAGCGTTGGAAG -> GGGTCCTAGCGTTGGAAGA
CACTGGCGACCTCGTACTT -> ACTGGCGACCTCGTACTTT
CGATTTAAAAGAACCCAGG -> GATTTAAAAGAACCCAGGT
CCGAGTAAGTCAGTATGGT -> CGAGTAAGTCAGTATGGTT
AAAGCGTCGAGCGGGCTCA -> AAGCGTCGAGCGGGCTCAT
TTTAAGTGTGTGTCCCCGC -> TTAAGTGTGTGTCCCCGCG
TCCATCGTAACGTACCACT -> CCATCGTAACGTACCACTG
CATTATCGATTCGCATCCT -> ATTATCGATTCGCATCCTC
TTCAAGTATTCGGGGCTAA -> TCAAGTATTCGGGGCTAAC
ATCGTGTCCGCCGACTTAG -> TCGTGTCCGCCGACTTAGG
CTATCGACGTTGCTTCCCT -> TATCGACGTTGCTTCCCTC
ACTCTGAGAGATTCTATTG -> CTCTGAGAGATTCTATTGA
GAGAGACTCTGGTGCTGCG -> AGAGACTCTGGTGCTGCGA
CCTCGTACTTTGATGCGAT -> CTCGTACTTTGATGCGATG
GAGCGTGTTACGGTCATAA -> AGCGTGTTACGGTCATAAC
TGAGAGATTCTATTGAAAA -> GAGAGATTCTATTGAAAAT
GTATGACGGCCGACCACTG -> TATGACGGCCGACCACTGG
CCTGATTGCGCATACGTAT -> CTGATTGCGCATACGTATT
ATTCTTAGGACGGGTGCCT -> TTCTTAGGACGGGTGCCTT
ATATTGTCATAGGTGTGTA -> TATTGTCATAGGTGTGTAC
GAAGAGGTTTTTGTAAAGC -> AAGAGGTTTTTGTAAAGCC
TATCTATTGGTACGCCGAC -> ATCTATTGGTACGCCGACG
ATATTTATCTCTACCCACC -> TATTTATCTCTACCCACCG
ACCATGTGAGGGCATGAGG -> CCATGTGAGGGCATGAGGG
TACGTACGTAATGCCTCCA -> ACGTACGTAATGCCTCCAG
CCAGAAGTCAAACCCGGGT -> CAGAAGTCAAACCCGGGTA
CAGAAGATGGCAGGCAAAG -> AGAAGATGGCAGGCAAAGG
CCCAACCGTCAATCTTCTT -> CCAACCGTCAATCTTCTTC
ACCGGAGTGGGCAGGTGGA -> CCGGAGTGGGCAGGTGGAC
TAGGTTGGTATTCTGAAGC -> AGGTTGGTATTCTGAAGCA
GCCAAAGCCCAACCGTCAA -> CCAAAGCCCAACCGTCAAT
GTGTTACCACAGAAGATGG -> TGTTACCACAGAAGATGGC
TCCCCGCGACCAAACCCCC -> CCCCGCGACCAAACCCCCT
GTGGTACATAGTCTATGTT -> TGGTACATAGTCTATGTTA
GCCCAACCGTCAATCTTCT -> CCCAACCGTCAATCTTCTT
ATGGAGCGCAGCTCATAGG -> TGGAGCGCAGCTCATAGGT
GCATTATGCTCGACCACCG -> CATTATGCTCGACCACCGC
TTGTGTGTTTTTCCATTAG -> TGTGTGTTTTTCCATTAGA
CAGTGAGTGCCACCTTTCG -> AGTGAGTGCCACCTTTCGG
GTCCTTATTATCCTGCTAC -> TCCTTATTATCCTGCTACT
GAAGTCAAACCCGGGTAAG -> AAGTCAAACCCGGGTAAGA
GCTGTTACTCCCGGGTACA -> CTGTTACTCCCGGGTACAT
CCCTATCGACGTTGCTTCC -> CCTATCGACGTTGCTTCCC
AAGCTGCCAAAGCCCAACC -> AGCTGCCAAAGCCCAACCG
GACCGCGTAAACACGAGCT -> ACCGCGTAAACACGAGCTA
GTAATGCCTCCAGTGCGAT -> TAATGCCTCCAGTGCGATT
ATGCTCGACCACCGCGGCG -> TGCTCGACCACCGCGGCGG
GACTCTGGTGCTGCGATCC -> ACTCTGGTGCTGCGATCCA
CATATCGCCATCAGAAGAT -> ATATCGCCATCAGAAGATA
AGTGCGTGGTACATAGTCT -> GTGCGTGGTACATAGTCTA
GGAGTACATTATCGATTCG -> GAGTACATTATCGATTCGC
TCTATTGGTACGCCGACGT -> CTATTGGTACGCCGACGTG
TTACACAACAGGCCTGTGG -> TACACAACAGGCCTGTGGA
TCGCACCAAGACTGGGGGT -> CGCACCAAGACTGGGGGTC
CTGAGATATACTGAGGGAC -> TGAGATATACTGAGGGACA
CGGGTGCCTTCTATTTGAG -> GGGTGCCTTCTATTTGAGT
CGCAAATATCCGTCCTTAT -> GCAAATATCCGTCCTTATT
TGTTACTCCCGGGTACATT -> GTTACTCCCGGGTACATTA
CCTACAATCCCATGGTAAT -> CTACAATCCCATGGTAATT
GGGTAAGAAGCTCTCCCTA -> GGTAAGAAGCTCTCCCTAC
GTATTATCATCGCGGTATT -> TATTATCATCGCGGTATTC
CTGTGGAGTGCTTGCTACT -> TGTGGAGTGCTTGCTACTG
CAATCTTCTTCGTCAGTCC -> AATCTTCTTCGTCAGTCCC
TTAAAGTTACACAACAGGC -> TAAAGTTACACAACAGGCC
GCTCATAGGTGGCGTGCGC -> CTCATAGGTGGCGTGCGCA
GTGCCAACCTCCCTGTTGA -> TGCCAACCTCCCTGTTGAA
TTATCCTGCTCAGCACCTG -> TATCCTGCTCAGCACCTGG
GTCCTAGCGTTGGAAGAAG -> TCCTAGCGTTGGAAGAAGC
CCAAGACTGGGGGTCCTCG -> CAAGACTGGGGGTCCTCGT
AGCAGAGGCGTTACGTGTC -> GCAGAGGCGTTACGTGTCG
AGTGCTGCAGCAGAGGCGT -> GTGCTGCAGCAGAGGCGTT
AGCTCTCCCTACTTAACCT -> GCTCTCCCTACTTAACCTG
GACCAAACCCCCTGGCAAA -> ACCAAACCCCCTGGCAAAC
CCATAAATATTGTCATAGG -> CATAAATATTGTCATAGGT
ATAACATGGCAATTGGCCC -> TAACATGGCAATTGGCCCT
AAACAAGCTGCCAAAGCCC -> AACAAGCTGCCAAAGCCCA
TACACAACAGGCCTGTGGA -> ACACAACAGGCCTGTGGAG
AACACACCGGCGTTGACTA -> ACACACCGGCGTTGACTAC
TAAATATTGTCATAGGTGT -> AAATATTGTCATAGGTGTG
ACAGTGAGTGCCACCTTTC -> CAGTGAGTGCCACCTTTCG
GATATTTATCTCTACCCAC -> ATATTTATCTCTACCCACC
CAAGGATAGCTCGGAGCTC -> AAGGATAGCTCGGAGCTCT
TTTCACGTCCCATAAATAT -> TTCACGTCCCATAAATATT
ATCGACAGTGCTGCAGCAG -> TCGACAGTGCTGCAGCAGA
CCCGGTTATGTTGTCACCA -> CCGGTTATGTTGTCACCAC
TGGGGTCCTAGCGTTGGAA -> GGGGTCCTAGCGTTGGAAG
GAGCTCTTACGTAATAGAT -> AGCTCTTACGTAATAGATC
AGCGTCCTTATTATCCTGC -> GCGTCCTTATTATCCTGCT
TAAGTGTGTGTCCCCGCGA -> AAGTGTGTGTCCCCGCGAC
ACGGAAACAAGCTGCCAAA -> CGGAAACAAGCTGCCAAAG
TTTGTGTTTATAAGCTGTA -> TTGTGTTTATAAGCTGTAG
CATCCTCGGTTGAAACGAA -> ATCCTCGGTTGAAACGAAT
ACTGAGATATACTGAGGGA -> CTGAGATATACTGAGGGAC
TAGATTCGTGCGTAACCCC -> AGATTCGTGCGTAACCCCC
TGCCACCTTTCGGGTAATG -> GCCACCTTTCGGGTAATGC
TCTTAGGCATTCGCCACCA -> CTTAGGCATTCGCCACCAG
AGAGGCGTTACGTGTCGTG -> GAGGCGTTACGTGTCGTGT
TTCGCATTGTGTGTTTTTC -> TCGCATTGTGTGTTTTTCC
TCGTGTCCGCCGACTTAGG -> CGTGTCCGCCGACTTAGGT
CAGGCTGTGCTCCCTCGCC -> AGGCTGTGCTCCCTCGCCC
AGTGGACCATCATATTAAA -> GTGGACCATCATATTAAAG
TGTGTGTTTTTCCATTAGA -> GTGTGTTTTTCCATTAGAT
GACTAAAGCGTCGAGCGGG -> ACTAAAGCGTCGAGCGGGC
CCGCGGCGGGGGTATCTAT -> CGCGGCGGGGGTATCTATT
TTCTGTACGGGTCTGGTGG -> TCTGTACGGGTCTGGTGGC
TGATGCGACGTGTACATTA -> GATGCGACGTGTACATTAT
GTCGAGCGGGCTCATGCTT -> TCGAGCGGGCTCATGCTTT
TCCCTACTTAACCTGGGAC -> CCCTACTTAACCTGGGACG
AAGTTGGGGCACAGCTGAC -> AGTTGGGGCACAGCTGACT
ATCGCGGTATTCAAAATGA -> TCGCGGTATTCAAAATGAA
TTATCCTGCTGTTACTCCC -> TATCCTGCTGTTACTCCCG
GTAATAGATCACGCGAGAC -> TAATAGATCACGCGAGACA
GTCTGCTATGAGAATACTC -> TCTGCTATGAGAATACTCT
AACCCCCCCTGCAGGATTA -> ACCCCCCCTGCAGGATTAT
CAACCGTCAATCTTCTTCG -> AACCGTCAATCTTCTTCGT
ACTAAATTACCCAGAAGTC -> CTAAATTACCCAGAAGTCA
TAAAGCGTCGAGCGGGCTC -> AAAGCGTCGAGCGGGCTCA
TAGAACCCACAATCACTCC -> AGAACCCACAATCACTCCA
GGGATACCTGCGCCGCGAT -> GGATACCTGCGCCGCGATA
CGCACCAAGACTGGGGGTC -> GCACCAAGACTGGGGGTCC
TGATTAAACTTAGTTAGGT -> GATTAAACTTAGTTAGGTG
GATTCGCATTCTTAGGACG -> ATTCGCATTCTTAGGACGG
CTTATTATCCTGCTCAGCA -> TTATTATCCTGCTCAGCAC
AACGTACCACTGAGATATA -> ACGTACCACTGAGATATAC
TATTTGAGTTCATCACACT -> ATTTGAGTTCATCACACTG
AAGCTGTAGCGTCCTTATT -> AGCTGTAGCGTCCTTATTA
AAGATGGCAGGCAAAGGAG -> AGATGGCAGGCAAAGGAGC
ACCACCGCGGCGGGGGTAT -> CCACCGCGGCGGGGGTATC
CCCTCTGACGACAACGTAT -> CCTCTGACGACAACGTATA
ATCGATTCGCATTGTGTGT -> TCGATTCGCATTGTGTGTT
GGTTATGTTGTCACCACAT -> GTTATGTTGTCACCACATG
TACCACAGAAGATGGCAGG -> ACCACAGAAGATGGCAGGC
AGGCTGTGCTCCCTCGCCC -> GGCTGTGCTCCCTCGCCCT
TGCTGCGATCCATGCTCGT -> GCTGCGATCCATGCTCGTC
CATTATCGATTCGCATTCT -> ATTATCGATTCGCATTCTT
TCTGTACGGGTCTGGTGGC -> CTGTACGGGTCTGGTGGCC
ACCGGCGTTGACTACGACC -> CCGGCGTTGACTACGACCT
TAGTTAGGTGGGGTGGCAA -> AGTTAGGTGGGGTGGCAAT
GTACGGGTCTGGTGGCCGG -> TACGGGTCTGGTGGCCGGT
CGCATACGTATTATCATCG -> GCATACGTATTATCATCGC
GCATGTATAGGCTCCCTTA -> CATGTATAGGCTCCCTTAG
GACTTAGGTTGGTATTCTG -> ACTTAGGTTGGTATTCTGA
CGTTAGGTTTTAGTGGACC -> GTTAGGTTTTAGTGGACCA
CGATTCGCATTCTTAGGAC -> GATTCGCATTCTTAGGACG
CTCGGTTGAAACGAATGGA -> TCGGTTGAAACGAATGGAG
CCTGTTGAACGGGATGAAG -> CTGTTGAACGGGATGAAGG
CAAGCTGCCAAAGCCCAAC -> AAGCTGCCAAAGCCCAACC
ATCACTCCATTACGCCAAG -> TCACTCCATTACGCCAAGA
CCGTAAGAACCCCGGAGGT -> CGTAAGAACCCCGGAGGTT
GAGATATACTGAGGGACAA -> AGATATACTGAGGGACAAC
TTACCTTCCAGCCTGTCCC -> TACCTTCCAGCCTGTCCCC
GCCTGTGGAGTGCTTGCTA -> CCTGTGGAGTGCTTGCTAC
ATCATCGCGGTATTCAAAA -> TCATCGCGGTATTCAAAAT
TCGCCATCAGAAGATATCG -> CGCCATCAGAAGATATCGG
GCTAGTGATCGACGTTGTT -> CTAGTGATCGACGTTGTTG
TAAGATTAGAACCTCGCAC -> AAGATTAGAACCTCGCACC
TCGTCCTTATTATCCTGCT -> CGTCCTTATTATCCTGCTT
CAAGCGTTACCTTCCAGCC -> AAGCGTTACCTTCCAGCCT
AAAGCTAAGATTAGAACCT -> AAGCTAAGATTAGAACCTC
CCAGTGCGATTCTTATGCC -> CAGTGCGATTCTTATGCCC
TCACTCGCCCTGTGGAGAG -> CACTCGCCCTGTGGAGAGA
TTAGGTTTTAGTGGACCAT -> TAGGTTTTAGTGGACCATC
ACGTTGCTTCCCTCCGCTC -> CGTTGCTTCCCTCCGCTCA
GCCACGACCGCGTAAACAC -> CCACGACCGCGTAAACACG
ACTGCGCCTTGTAGGGTCG -> CTGCGCCTTGTAGGGTCGC
ATACCTGCGCCGCGATATA -> TACCTGCGCCGCGATATAC
GAAACGAATGGAGAGGCGC -> AAACGAATGGAGAGGCGCT
CTGCTACTGTCGTTGTGTA -> TGCTACTGTCGTTGTGTAC
CCAAGCGTTACCTTCCAGC -> CAAGCGTTACCTTCCAGCC
TACGACCTAGTCGTCCTTA -> ACGACCTAGTCGTCCTTAT
ATAGGCTCCCTTAGACAGT -> TAGGCTCCCTTAGACAGTT
TGTGTACATTATCGATTCG -> GTGTACATTATCGATTCGC
TATACAAGGATAGCTCGGA -> ATACAAGGATAGCTCGGAG
AATATCCGTCCTTATTATC -> ATATCCGTCCTTATTATCC
TATTTTGTGTTTATAAGCT -> ATTTTGTGTTTATAAGCTG
CGCCTTGTAGGGTCGCCGG -> GCCTTGTAGGGTCGCCGGG
GCGGGGGTATCTATTGGTA -> CGGGGGTATCTATTGGTAC
ATGGCAGGCAAAGGAGCGT -> TGGCAGGCAAAGGAGCGTG
CGTCCTTATTATCCTGCTG -> GTCCTTATTATCCTGCTGT
AGTCGTCCTTATTATCCTG -> GTCGTCCTTATTATCCTGC
TCGTAGCCATCGACAGTGC -> CGTAGCCATCGACAGTGCT
CGTCACGAACGATTTAAAA -> GTCACGAACGATTTAAAAG
AGATTCTATTGAAAATACC -> GATTCTATTGAAAATACCT
CGTCAAGTTGGGGCACAGC -> GTCAAGTTGGGGCACAGCT
GGAGGTTCAAGTATTCGGG -> GAGGTTCAAGTATTCGGGG
AATCCTACAATCCCATGGT -> ATCCTACAATCCCATGGTA
GCTTTCACGTCCCATAAAT -> CTTTCACGTCCCATAAATA
CAGAGGCGTTACGTGTCGT -> AGAGGCGTTACGTGTCGTG
CGACAGTGCTGCAGCAGAG -> GACAGTGCTGCAGCAGAGG
TTAAAAGAACCCAGGTGTT -> TAAAAGAACCCAGGTGTTA
CGTAATAGATCACGCGAGA -> GTAATAGATCACGCGAGAC
GAGATTCTATTGAAAATAC -> AGATTCTATTGAAAATACC
AGCGTGTTACGGTCATAAC -> GCGTGTTACGGTCATAACA
ATTGAAAATACCTAGAACC -> TTGAAAATACCTAGAACCC
TTTATCTCTACCCACCGCT -> TTATCTCTACCCACCGCTG
ATCGATTCGCATTCCTGAT -> TCGATTCGCATTCCTGATT
TATACTGAGGGACAACAGA -> ATACTGAGGGACAACAGAA
CAAACAACCGGAGTGGGCA -> AAACAACCGGAGTGGGCAG
ATCCATGCTCGTCAAGTTG -> TCCATGCTCGTCAAGTTGG
CCGGGCTTGATTACCGAGT -> CGGGCTTGATTACCGAGTA
GGATACTAAATTACCCAGA -> GATACTAAATTACCCAGAA
ACAGTGCTGCAGCAGAGGC -> CAGTGCTGCAGCAGAGGCG
GCCCTCTGACGACAACGTA -> CCCTCTGACGACAACGTAT
CCCGGAGGTTCAAGTATTC -> CCGGAGGTTCAAGTATTCG
TGTGCTCCCTCGCCCTCAG -> GTGCTCCCTCGCCCTCAGT
GCATTGTGTGTTTTTCCAT -> CATTGTGTGTTTTTCCATT
TCCTGCTACTGTCGTTGTG -> CCTGCTACTGTCGTTGTGT
CAGTCGGTCTTAGGCATTC -> AGTCGGTCTTAGGCATTCG
TGGTGCTGCGATCCATGCT -> GGTGCTGCGATCCATGCTC
GTGTGTACGTACGTAATGC -> TGTGTACGTACGTAATGCC
CTTCTTCGTCAGTCCCGTA -> TTCTTCGTCAGTCCCGTAA
ATTCTTATGCCCTATCGAC -> TTCTTATGCCCTATCGACG
ACAGAAGGGGGACCTGCCC -> CAGAAGGGGGACCTGCCCG
CACTCGCCCTGTGGAGAGA -> ACTCGCCCTGTGGAGAGAC
ATGCCAAGCGTTACCTTCC -> TGCCAAGCGTTACCTTCCA
AAGCCCAACCGTCAATCTT -> AGCCCAACCGTCAATCTTC
AGGTGGCGTGCGCATGACC -> GGTGGCGTGCGCATGACCC
GCGTTTTTAAGTGTGTGTC -> CGTTTTTAAGTGTGTGTCC
GGAAACAAGCTGCCAAAGC -> GAAACAAGCTGCCAAAGCC
CTCTCCCTACTTAACCTGG -> TCTCCCTACTTAACCTGGG
CGCCCTGTGGAGAGACTCT -> GCCCTGTGGAGAGACTCTG
GCTGGGGAAAGCCAGTGTA -> CTGGGGAAAGCCAGTGTAG
ACACAACAGGCCTGTGGAG -> CACAACAGGCCTGTGGAGT
CCTGCGCCGCGATATACAA -> CTGCGCCGCGATATACAAG
ACCCGGTTATGTTGTCACC -> CCCGGTTATGTTGTCACCA
CGACGTTGCTTCCCTCCGC -> GACGTTGCTTCCCTCCGCT
TGGAGAGACTCTGGTGCTG -> GGAGAGACTCTGGTGCTGC
TCTGAAGCATGTATAGGCT -> CTGAAGCATGTATAGGCTC
CTGAAATGTCAGTCGGTCT -> TGAAATGTCAGTCGGTCTT
CGAGCGGGCTCATGCTTTC -> GAGCGGGCTCATGCTTTCA
GTTATGCCACTGGCGACCT -> TTATGCCACTGGCGACCTC
ATTATCCTGCTTGATGCGA -> TTATCCTGCTTGATGCGAC
GAAAGCCAGTGTAGCGTGG -> AAAGCCAGTGTAGCGTGGC
CCGCGTAAACACGAGCTAG -> CGCGTAAACACGAGCTAGT
CTATCTTCACTCGCCCTGT -> TATCTTCACTCGCCCTGTG
GTTGGTGGTATGTAAGAGA -> TTGGTGGTATGTAAGAGAG
TTATCGATTCGCATTCTTA -> TATCGATTCGCATTCTTAG
CTGCCCGGCCACGACCGCG -> TGCCCGGCCACGACCGCGT
CTGCGTTGACCGCGTATTT -> TGCGTTGACCGCGTATTTT
TGGCCGGTAAAAACAGCGT -> GGCCGGTAAAAACAGCGTC
ACCTTCCAGCCTGTCCCCT -> CCTTCCAGCCTGTCCCCTA
TGTAGCGTCCTTATTATCC -> GTAGCGTCCTTATTATCCT
ACAACGTATAGTCGTGGCC -> CAACGTATAGTCGTGGCCA
GGCGTGCGCATGACCCAAT -> GCGTGCGCATGACCCAATC
ATTAAAGTTACACAACAGG -> TTAAAGTTACACAACAGGC
TAAACTTAGTTAGGTGGGG -> AAACTTAGTTAGGTGGGGT
CCCCATATCGCCATCAGAA -> CCCATATCGCCATCAGAAG
TCGTCCGAACACACCGGCG -> CGTCCGAACACACCGGCGT
TGGCAAACAACCGGAGTGG -> GGCAAACAACCGGAGTGGG
GTTTATAAGCTGTAGCGTC -> TTTATAAGCTGTAGCGTCC
ACGATTTAAAAGAACCCAG -> CGATTTAAAAGAACCCAGG
GATTCGCATTCCTGATTGC -> ATTCGCATTCCTGATTGCG
TTATAAGCTGTAGCGTCCT -> TATAAGCTGTAGCGTCCTT
TAATAGATCACGCGAGACA -> AATAGATCACGCGAGACAG
AGGCATTCGCCACCAGCCC -> GGCATTCGCCACCAGCCCT
ATCACGCGAGACAGTGAGT -> TCACGCGAGACAGTGAGTG
AATTGGCCCTGCGTTGACC -> ATTGGCCCTGCGTTGACCG
CCTGCGTTGACCGCGTATT -> CTGCGTTGACCGCGTATTT
CAGCACCTGGAGTACATTA -> AGCACCTGGAGTACATTAT
CCTAGCGTTGGAAGAAGCT -> CTAGCGTTGGAAGAAGCTG
TGGATACTAAATTACCCAG -> GGATACTAAATTACCCAGA
AGTGCCACCTTTCGGGTAA -> GTGCCACCTTTCGGGTAAT
CAATCCCATGGTAATTCTG -> AATCCCATGGTAATTCTGA
GCTGGGCTGCTTCGTCACG -> CTGGGCTGCTTCGTCACGA
GCGTTACGTGTCGTGTACG -> CGTTACGTGTCGTGTACGA
GAGACTATCTTCACTCGCC -> AGACTATCTTCACTCGCCC
CCCTCGCCCTCAGTGTATG -> CCTCGCCCTCAGTGTATGA
CGTAAGAACCCCGGAGGTT -> GTAAGAACCCCGGAGGTTC
CGGTTATGCCACTGGCGAC -> GGTTATGCCACTGGCGACC
TGTGTTTTTCCATTAGATT -> GTGTTTTTCCATTAGATTC
CTAGAACCCACAATCACTC -> TAGAACCCACAATCACTCC
TGTCATAGGTGTGTACGTA -> GTCATAGGTGTGTACGTAC
AGGTGTTACCACAGAAGAT -> GGTGTTACCACAGAAGATG
GTCAGTCGGTCTTAGGCAT -> TCAGTCGGTCTTAGGCATT
TATCCTGCTGTTACTCCCG -> ATCCTGCTGTTACTCCCGG
TGTACGGGTCTGGTGGCCG -> GTACGGGTCTGGTGGCCGG
TCCAGTGCGATTCTTATGC -> CCAGTGCGATTCTTATGCC
CGAGTAAGTCAGTATGGTT -> GAGTAAGTCAGTATGGTTA
CGTAGCCATCGACAGTGCT -> GTAGCCATCGACAGTGCTG
CATCTCGGGATACCTGCGC -> ATCTCGGGATACCTGCGCC
AAATTACCCAGAAGTCAAA -> AATTACCCAGAAGTCAAAC
TAGGACGGGTGCCTTCTAT -> AGGACGGGTGCCTTCTATT
TGTAGCGTGGCTTACTGCG -> GTAGCGTGGCTTACTGCGC
GGCGTTACGTGTCGTGTAC -> GCGTTACGTGTCGTGTACG
ACCCAGAAGTCAAACCCGG -> CCCAGAAGTCAAACCCGGG
CCTGGAGTACATTATCGAT -> CTGGAGTACATTATCGATT
CGACCTAGTCGTCCTTATT -> GACCTAGTCGTCCTTATTA
CAGGTGGACGGAATCCTAC -> AGGTGGACGGAATCCTACA
CCTTGTAGGGTCGCCGGGC -> CTTGTAGGGTCGCCGGGCT
TAGCGTTGGAAGAAGCTGG -> AGCGTTGGAAGAAGCTGGG
GTGGGGTGGCAATTGCTTC -> TGGGGTGGCAATTGCTTCT
AATGAAGAGGTTTTTGTAA -> ATGAAGAGGTTTTTGTAAA
CTTATTATCCTGCTTGATG -> TTATTATCCTGCTTGATGC
GCTCAGCACCTGGAGTACA -> CTCAGCACCTGGAGTACAT
GTGGGCTAGTGCGTGGTAC -> TGGGCTAGTGCGTGGTACA
GTGGCGTGCGCATGACCCA -> TGGCGTGCGCATGACCCAA
TCTGCTATGAGAATACTCT -> CTGCTATGAGAATACTCTG
ACTGGCGACCTCGTACTTT -> CTGGCGACCTCGTACTTTG
ACTCCATTACGCCAAGAGA -> CTCCATTACGCCAAGAGAC
CCCTTAGACAGTTTCAGTC -> CCTTAGACAGTTTCAGTCG
ACCCCGGAGGTTCAAGTAT -> CCCCGGAGGTTCAAGTATT
GGTGGCAATTGCTTCTGTA -> GTGGCAATTGCTTCTGTAC
AGATATACTGAGGGACAAC -> GATATACTGAGGGACAACA
GTACATTATCGATTCGCAT -> TACATTATCGATTCGCATT,TACATTATCGATTCGCATC,TACATTATCGATTCGCATT,TACATTATCGATTCGCATT
GCCGACGTGGGCTAGTGCG -> CCGACGTGGGCTAGTGCGT
ATACTAAATTACCCAGAAG -> TACTAAATTACCCAGAAGT
TTAGTTAGGTGGGGTGGCA -> TAGTTAGGTGGGGTGGCAA
ATGAAGGTCGGTTATGCCA -> TGAAGGTCGGTTATGCCAC
CTAGTGCGTGGTACATAGT -> TAGTGCGTGGTACATAGTC
CGGCGTTGACTACGACCTA -> GGCGTTGACTACGACCTAG
GTTACCACAGAAGATGGCA -> TTACCACAGAAGATGGCAG
TGGACGGAATCCTACAATC -> GGACGGAATCCTACAATCC
GTAAAAACAGCGTCCTGGA -> TAAAAACAGCGTCCTGGAT
CCATGGTAATTCTGATCAA -> CATGGTAATTCTGATCAAT
TCGACGTTGTTGGTGGTAT -> CGACGTTGTTGGTGGTATG
GTCGTCCTTATTATCCTGC -> TCGTCCTTATTATCCTGCT
AGTCAAACCCGGGTAAGAA -> GTCAAACCCGGGTAAGAAG
CGATTCGCATCCTCGGTTG -> GATTCGCATCCTCGGTTGA
GCGTAAACACGAGCTAGTG -> CGTAAACACGAGCTAGTGA
TGCGATTCTTATGCCCTAT -> GCGATTCTTATGCCCTATC
GTCGTCCGAACACACCGGC -> TCGTCCGAACACACCGGCG
CAACGTATAGTCGTGGCCA -> AACGTATAGTCGTGGCCAG
GCAGAGGCGTTACGTGTCG -> CAGAGGCGTTACGTGTCGT
GCATGACCCAATCATGAGT -> CATGACCCAATCATGAGTG
AGAGACTCTGGTGCTGCGA -> GAGACTCTGGTGCTGCGAT
CCCAGAAGTCAAACCCGGG -> CCAGAAGTCAAACCCGGGT
GACCATCATATTAAAGTTA -> ACCATCATATTAAAGTTAC
ACCCAGGTGTTACCACAGA -> CCCAGGTGTTACCACAGAA
GTAAAGCCCGTTAGGTTTT -> TAAAGCCCGTTAGGTTTTA
TACAATCCCATGGTAATTC -> ACAATCCCATGGTAATTCT
CCACATGCATCCACAATCG -> CACATGCATCCACAATCGT
CGTAATGCCTCCAGTGCGA -> GTAATGCCTCCAGTGCGAT
GTTGGAAGAAGCTGGGCTG -> TTGGAAGAAGCTGGGCTGC
TCAGTCCCGTAAGAACCCC -> CAGTCCCGTAAGAACCCCG
AGATCACGCGAGACAGTGA -> GATCACGCGAGACAGTGAG
TCCCTGTTGAACGGGATGA -> CCCTGTTGAACGGGATGAA
GTCCCCTAACGCAAATATC -> TCCCCTAACGCAAATATCC
TTTTCCATTAGATTCGTGC -> TTTCCATTAGATTCGTGCG
CCCGTTAGGTTTTAGTGGA -> CCGTTAGGTTTTAGTGGAC
CTGGAGTACATTATCGATT -> TGGAGTACATTATCGATTC
GTTAGGTTTTAGTGGACCA -> TTAGGTTTTAGTGGACCAT
CGTACGTAATGCCTCCAGT -> GTACGTAATGCCTCCAGTG
AGTGATCGACGTTGTTGGT -> GTGATCGACGTTGTTGGTG
TCGAGCGGGCTCATGCTTT -> CGAGCGGGCTCATGCTTTC
CACCAAGACTGGGGGTCCT -> ACCAAGACTGGGGGTCCTC
TTATTCTAGGCATTATGCT -> TATTCTAGGCATTATGCTC
CCCGCGACCAAACCCCCTG -> CCGCGACCAAACCCCCTGG
GCCGCGATATACAAGGATA -> CCGCGATATACAAGGATAG
TCCTAGCGTTGGAAGAAGC -> CCTAGCGTTGGAAGAAGCT
TATTTATCTCTACCCACCG -> ATTTATCTCTACCCACCGC
ACGAGCTAGTGATCGACGT -> CGAGCTAGTGATCGACGTT
CACACCGGCGTTGACTACG -> ACACCGGCGTTGACTACGA
GTCCCCGCGACCAAACCCC -> TCCCCGCGACCAAACCCCC
TGGAGAGGCGCTCCCCATA -> GGAGAGGCGCTCCCCATAT
GAGAGGCGCTCCCCATATC -> AGAGGCGCTCCCCATATCG
GCAAACAACCGGAGTGGGC -> CAAACAACCGGAGTGGGCA
GAGTGCCACCTTTCGGGTA -> AGTGCCACCTTTCGGGTAA
TATCATCGCGGTATTCAAA -> ATCATCGCGGTATTCAAAA
GCTACTGTCGTTGTGTACA -> CTACTGTCGTTGTGTACAT
AGAGAGCTAGATTCAGGCT -> GAGAGCTAGATTCAGGCTG
ATAGTCTATGTTAGATTGA -> TAGTCTATGTTAGATTGAT
GTCTATGTTAGATTGATAT -> TCTATGTTAGATTGATATT
CTATGTTAGATTGATATTT -> TATGTTAGATTGATATTTA
GGAGAGGCGCTCCCCATAT -> GAGAGGCGCTCCCCATATC
TGAGAATACTCTGAGAGAT -> GAGAATACTCTGAGAGATT
TCGATTCGCATTGTGTGTT -> CGATTCGCATTGTGTGTTT
GGAATCCTACAATCCCATG -> GAATCCTACAATCCCATGG
GAGTGAACATATGGACGGA -> AGTGAACATATGGACGGAA
GGACGGAAACAAGCTGCCA -> GACGGAAACAAGCTGCCAA
TTGTGTTTATAAGCTGTAG -> TGTGTTTATAAGCTGTAGC
TTCTAGGCATTATGCTCGA -> TCTAGGCATTATGCTCGAC
TTTGATTAAACTTAGTTAG -> TTGATTAAACTTAGTTAGG
CTACCCACCGCTGCATCGT -> TACCCACCGCTGCATCGTG
ATAAATATTGTCATAGGTG -> TAAATATTGTCATAGGTGT
GCTGCAGCAGAGGCGTTAC -> CTGCAGCAGAGGCGTTACG
GCGATGGGGTCCTAGCGTT -> CGATGGGGTCCTAGCGTTG
GGGGGTCCTCGTAGCCATC -> GGGGTCCTCGTAGCCATCG
TGGCGTGCGCATGACCCAA -> GGCGTGCGCATGACCCAAT
CAGGTGTTACCACAGAAGA -> AGGTGTTACCACAGAAGAT
TGGGCTGCTTCGTCACGAA -> GGGCTGCTTCGTCACGAAC
GCTCTTACGTAATAGATCA -> CTCTTACGTAATAGATCAC
GTCGGTCTTAGGCATTCGC -> TCGGTCTTAGGCATTCGCC
ACCACATGCATCCACAATC -> CCACATGCATCCACAATCG
CATGTATAGGCTCCCTTAG -> ATGTATAGGCTCCCTTAGA
GCTGCCAAAGCCCAACCGT -> CTGCCAAAGCCCAACCGTC
TAAGTTTCCTCTTTGATTA -> AAGTTTCCTCTTTGATTAA
TATTATCCTGCTACTGTCG -> ATTATCCTGCTACTGTCGT
TTATTATCCTGCTCAGCAC -> TATTATCCTGCTCAGCACC
TTGCTTCTGTACGGGTCTG -> TGCTTCTGTACGGGTCTGG
CACCAGCCCTCTGACGACA -> ACCAGCCCTCTGACGACAA
TACGTATTATCATCGCGGT -> ACGTATTATCATCGCGGTA
GATCGACGTTGTTGGTGGT -> ATCGACGTTGTTGGTGGTA
GACGTTGTTGGTGGTATGT -> ACGTTGTTGGTGGTATGTA
GGATGAAGGTCGGTTATGC -> GATGAAGGTCGGTTATGCC
CCATCAGAAGATATCGGTT -> CATCAGAAGATATCGGTTA
GCACCTGGAGTACATTATC -> CACCTGGAGTACATTATCG
GTGTCGTGTACGAGAGGTC -> TGTCGTGTACGAGAGGTCT
CCGCTGCATCGTGTCCGCC -> CGCTGCATCGTGTCCGCCG
TTCGGGTAATGCCAAGCGT -> TCGGGTAATGCCAAGCGTT
CGTGCCAACCTCCCTGTTG -> GTGCCAACCTCCCTGTTGA
GACGACAACGTATAGTCGT -> ACGACAACGTATAGTCGTG
AAATGAAGAGGTTTTTGTA -> AATGAAGAGGTTTTTGTAA
CCACCAGCCCTCTGACGAC -> CACCAGCCCTCTGACGACA
CAGTATGGTTATGTCCATC -> AGTATGGTTATGTCCATCG
CCACTGGCGACCTCGTACT -> CACTGGCGACCTCGTACTT
TTGTAAAGCCCGTTAGGTT -> TGTAAAGCCCGTTAGGTTT
CCGACTTAGGTTGGTATTC -> CGACTTAGGTTGGTATTCT
AGGCGTTACGTGTCGTGTA -> GGCGTTACGTGTCGTGTAC
CACAGCTGACTCGAGTTGC -> ACAGCTGACTCGAGTTGCC
ATTACGCCAAGAGACTATC -> TTACGCCAAGAGACTATCT
GACCTCGTACTTTGATGCG -> ACCTCGTACTTTGATGCGA
TATGTCCATCGTAACGTAC -> ATGTCCATCGTAACGTACC
TTACCACAGAAGATGGCAG -> TACCACAGAAGATGGCAGG
TACATAGTCTATGTTAGAT -> ACATAGTCTATGTTAGATT
TGCTTCGTCACGAACGATT -> GCTTCGTCACGAACGATTT
AATTGCTTCTGTACGGGTC -> ATTGCTTCTGTACGGGTCT
AACCCGGGTAAGAAGCTCT -> ACCCGGGTAAGAAGCTCTC
ATTATTTTATTCTAGGCAT -> TTATTTTATTCTAGGCATT
TGAGGGCATGAGGGTGTGC -> GAGGGCATGAGGGTGTGCC
AGTGTGTGTCCCCGCGACC -> GTGTGTGTCCCCGCGACCA
ACCACTGAGATATACTGAG -> CCACTGAGATATACTGAGG
CCACTGAGATATACTGAGG -> CACTGAGATATACTGAGGG
ATACTCTGAGAGATTCTAT -> TACTCTGAGAGATTCTATT
CTGTCCCCTAACGCAAATA -> TGTCCCCTAACGCAAATAT
CGATATACAAGGATAGCTC -> GATATACAAGGATAGCTCG
TATGCCCTATCGACGTTGC -> ATGCCCTATCGACGTTGCT
TAAGAAGCTCTCCCTACTT -> AAGAAGCTCTCCCTACTTA
CCCATGGTAATTCTGATCA -> CCATGGTAATTCTGATCAA
TAGATTCAGGCTGTGCTCC -> AGATTCAGGCTGTGCTCCC
ACTGAGGGACAACAGAAGG -> CTGAGGGACAACAGAAGGG
CAACCGGAGTGGGCAGGTG -> AACCGGAGTGGGCAGGTGG
GTATTCGGGGCTAACCATG -> TATTCGGGGCTAACCATGT
CCCCCTGGCAAACAACCGG -> CCCCTGGCAAACAACCGGA
GTCCCGTAAGAACCCCGGA -> TCCCGTAAGAACCCCGGAG
GTTTTTGTAAAGCCCGTTA -> TTTTTGTAAAGCCCGTTAG
TGACCGCGTATTTTGTGTT -> GACCGCGTATTTTGTGTTT
ATTATCCTGCTGTTACTCC -> TTATCCTGCTGTTACTCCC
GGTGTTACCACAGAAGATG -> GTGTTACCACAGAAGATGG
CTACAATCCCATGGTAATT -> TACAATCCCATGGTAATTC
ATTCAAAATGAAGAGGTTT -> TTCAAAATGAAGAGGTTTT
GCCAAGCGTTACCTTCCAG -> CCAAGCGTTACCTTCCAGC
TCATAGGTGGCGTGCGCAT -> CATAGGTGGCGTGCGCATG
ACCCCCTGGCAAACAACCG -> CCCCCTGGCAAACAACCGG
GTTATGTTGTCACCACATG -> TTATGTTGTCACCACATGC
TCCGCGTTTTTAAGTGTGT -> CCGCGTTTTTAAGTGTGTG
TTCGCATTCTTAGGACGGG -> TCGCATTCTTAGGACGGGT
CAAATATCCGTCCTTATTA -> AAATATCCGTCCTTATTAT
CTTATTATCCTGCTACTGT -> TTATTATCCTGCTACTGTC
CGCGACCAAACCCCCTGGC -> GCGACCAAACCCCCTGGCA
CATGCTTTCACGTCCCATA -> ATGCTTTCACGTCCCATAA
GTTGTCACCACATGCATCC -> TTGTCACCACATGCATCCA
CGACGTGTACATTATCGAT -> GACGTGTACATTATCGATT
TGTAGGGTCGCCGGGCTTG -> GTAGGGTCGCCGGGCTTGA
AGATATCGGTTACATCTCG -> GATATCGGTTACATCTCGG
AGTCCCGTAAGAACCCCGG -> GTCCCGTAAGAACCCCGGA
TTATCCTGCTTGATGCGAC -> TATCCTGCTTGATGCGACG
ATTCTATTGAAAATACCTA -> TTCTATTGAAAATACCTAG
GTTTTTAAGTGTGTGTCCC -> TTTTTAAGTGTGTGTCCCC
GTCAGTATGGTTATGTCCA -> TCAGTATGGTTATGTCCAT
GGAGTGCTTGCTACTGAAA -> GAGTGCTTGCTACTGAAAT
CTCCCTTAGACAGTTTCAG -> TCCCTTAGACAGTTTCAGT
AGTCGGTCTTAGGCATTCG -> GTCGGTCTTAGGCATTCGC
CGTTGTTGGTGGTATGTAA -> GTTGTTGGTGGTATGTAAG
TAGATCACGCGAGACAGTG -> AGATCACGCGAGACAGTGA
TTATGCCACTGGCGACCTC -> TATGCCACTGGCGACCTCG
TCATTCCGCGTTTTTAAGT -> CATTCCGCGTTTTTAAGTG
TACCCAGAAGTCAAACCCG -> ACCCAGAAGTCAAACCCGG
GACGTCCTTATTATCCTGC -> ACGTCCTTATTATCCTGCT
GTGGAGTGCTTGCTACTGA -> TGGAGTGCTTGCTACTGAA
AACCCCGGAGGTTCAAGTA -> ACCCCGGAGGTTCAAGTAT
GACGGCCGACCACTGGGTC -> ACGGCCGACCACTGGGTCA
CCTGTCCCCTAACGCAAAT -> CTGTCCCCTAACGCAAATA
CCATTACGCCAAGAGACTA -> CATTACGCCAAGAGACTAT
TCGGAGCTCTTACGTAATA -> CGGAGCTCTTACGTAATAG
TTGGAAGAAGCTGGGCTGC -> TGGAAGAAGCTGGGCTGCT
ACGCGAGACAGTGAGTGCC -> CGCGAGACAGTGAGTGCCA
CAATTGGCCCTGCGTTGAC -> AATTGGCCCTGCGTTGACC
AGCGTGGCTTACTGCGCCT -> GCGTGGCTTACTGCGCCTT
AAGGGGGACCTGCCCGGCC -> AGGGGGACCTGCCCGGCCA
CCGGAGGTTCAAGTATTCG -> CGGAGGTTCAAGTATTCGG
TGCTGCAGCAGAGGCGTTA -> GCTGCAGCAGAGGCGTTAC
CATCGTGTCCGCCGACTTA -> ATCGTGTCCGCCGACTTAG
ACTGGGGGTCCTCGTAGCC -> CTGGGGGTCCTCGTAGCCA
ACATATGGACGGAAACAAG -> CATATGGACGGAAACAAGC
ATTCGCATTGTGTGTTTTT -> TTCGCATTGTGTGTTTTTC
TGATGCGATGGGGTCCTAG -> GATGCGATGGGGTCCTAGC
TACGCCAAGAGACTATCTT -> ACGCCAAGAGACTATCTTC
GGGTGGCAATTGCTTCTGT -> GGTGGCAATTGCTTCTGTA
TCAATGGAGCGCAGCTCAT -> CAATGGAGCGCAGCTCATA
TCTGATCAATGGAGCGCAG -> CTGATCAATGGAGCGCAGC
AGATTCGTGCGTAACCCCC -> GATTCGTGCGTAACCCCCC
AGGGGGACCTGCCCGGCCA -> GGGGGACCTGCCCGGCCAC
TGTCCATCGTAACGTACCA -> GTCCATCGTAACGTACCAC
AGATGGCAGGCAAAGGAGC -> GATGGCAGGCAAAGGAGCG
TTGGGGCACAGCTGACTCG -> TGGGGCACAGCTGACTCGA
ATATACTGAGGGACAACAG -> TATACTGAGGGACAACAGA
AGAAGATGGCAGGCAAAGG -> GAAGATGGCAGGCAAAGGA
TTATGTTGTCACCACATGC -> TATGTTGTCACCACATGCA
GTATGGTTATGTCCATCGT -> TATGGTTATGTCCATCGTA
AAGAGGTTTTTGTAAAGCC -> AGAGGTTTTTGTAAAGCCC
GACCCAATCATGAGTGAAC -> ACCCAATCATGAGTGAACA
CACGAACGATTTAAAAGAA -> ACGAACGATTTAAAAGAAC
GGCCGACCACTGGGTCATT -> GCCGACCACTGGGTCATTC
ATCAGAAGATATCGGTTAC -> TCAGAAGATATCGGTTACA
AAGAGACTATCTTCACTCG -> AGAGACTATCTTCACTCGC
TCACGAACGATTTAAAAGA -> CACGAACGATTTAAAAGAA
GCAGGTGGACGGAATCCTA -> CAGGTGGACGGAATCCTAC
AAGTTTCCTCTTTGATTAA -> AGTTTCCTCTTTGATTAAA
ATATCGGTTACATCTCGGG -> TATCGGTTACATCTCGGGA
CCACTGGGTCATTCCGCGT -> CACTGGGTCATTCCGCGTT
CGTGGTACATAGTCTATGT -> GTGGTACATAGTCTATGTT
GTACGCCGACGTGGGCTAG -> TACGCCGACGTGGGCTAGT
CATTCGCCACCAGCCCTCT -> ATTCGCCACCAGCCCTCTG
TGAGTGCCACCTTTCGGGT -> GAGTGCCACCTTTCGGGTA
ACTCGCCCTGTGGAGAGAC -> CTCGCCCTGTGGAGAGACT
GAAGCTCTCCCTACTTAAC -> AAGCTCTCCCTACTTAACC
GGGCTCATGCTTTCACGTC -> GGCTCATGCTTTCACGTCC
AACAGAAGGGGGACCTGCC -> ACAGAAGGGGGACCTGCCC
CCGGCTGATAAGTTTCCTC -> CGGCTGATAAGTTTCCTCT
CTAACGCAAATATCCGTCC -> TAACGCAAATATCCGTCCT
CACAATCACTCCATTACGC -> ACAATCACTCCATTACGCC
GGAGCGTGTTACGGTCATA -> GAGCGTGTTACGGTCATAA
CATGTGAGGGCATGAGGGT -> ATGTGAGGGCATGAGGGTG
TGAACGGGATGAAGGTCGG -> GAACGGGATGAAGGTCGGT
ACTGAAATGTCAGTCGGTC -> CTGAAATGTCAGTCGGTCT
AGTGAGTGCCACCTTTCGG -> GTGAGTGCCACCTTTCGGG
CATATGGACGGAAACAAGC -> ATATGGACGGAAACAAGCT
ACTACGACCTAGTCGTCCT -> CTACGACCTAGTCGTCCTT
TTAGATTGATATTTATCTC -> TAGATTGATATTTATCTCT
GCCGGTAAAAACAGCGTCC -> CCGGTAAAAACAGCGTCCT
CATTACGCCAAGAGACTAT -> ATTACGCCAAGAGACTATC
CCGGCGTTGACTACGACCT -> CGGCGTTGACTACGACCTA
TGGTGGCCGGTAAAAACAG -> GGTGGCCGGTAAAAACAGC
TTGATATTTATCTCTACCC -> TGATATTTATCTCTACCCA
TGACGACAACGTATAGTCG -> GACGACAACGTATAGTCGT
TGCCGCGACTAAAGCGTCG -> GCCGCGACTAAAGCGTCGA
TAAAAACAGCGTCCTGGAT -> AAAAACAGCGTCCTGGATA
CAACCTCCCTGTTGAACGG -> AACCTCCCTGTTGAACGGG
CCCAATCATGAGTGAACAT -> CCAATCATGAGTGAACATA
GGCTGATAAGTTTCCTCTT -> GCTGATAAGTTTCCTCTTT
CAGCTGACTCGAGTTGCCG -> AGCTGACTCGAGTTGCCGG
ATGCATCCACAATCGTCGT -> TGCATCCACAATCGTCGTG
CGTCCTTATTATCCTGCTA -> GTCCTTATTATCCTGCTAC
TCGCATTCCTGATTGCGCA -> CGCATTCCTGATTGCGCAT
GCTGATAAGTTTCCTCTTT -> CTGATAAGTTTCCTCTTTG
TACTGTCGTTGTGTACATT -> ACTGTCGTTGTGTACATTA
GCGTAACCCCCCCTGCAGG -> CGTAACCCCCCCTGCAGGA
GCTCCCCATATCGCCATCA -> CTCCCCATATCGCCATCAG
AGTTGGGGCACAGCTGACT -> GTTGGGGCACAGCTGACTC
TGTCACCACATGCATCCAC -> GTCACCACATGCATCCACA
ACAACAGGCCTGTGGAGTG -> CAACAGGCCTGTGGAGTGC
AGTTTCAGTCGTCCGAACA -> GTTTCAGTCGTCCGAACAC
AGATTCAGGCTGTGCTCCC -> GATTCAGGCTGTGCTCCCT
CTAGGCATTATGCTCGACC -> TAGGCATTATGCTCGACCA
AGCGTTACCTTCCAGCCTG -> GCGTTACCTTCCAGCCTGT
GTGTGTGTCCCCGCGACCA -> TGTGTGTCCCCGCGACCAA
GGCCCTGCGTTGACCGCGT -> GCCCTGCGTTGACCGCGTA
TTTGTAAAGCCCGTTAGGT -> TTGTAAAGCCCGTTAGGTT
GCTGCATCGTGTCCGCCGA -> CTGCATCGTGTCCGCCGAC
TGCGCATACGTATTATCAT -> GCGCATACGTATTATCATC
GTAATTCTGATCAATGGAG -> TAATTCTGATCAATGGAGC
TTATTATCCTGCTTGATGC -> TATTATCCTGCTTGATGCG
ACGCCGACGTGGGCTAGTG -> CGCCGACGTGGGCTAGTGC
GCGCTCCCCATATCGCCAT -> CGCTCCCCATATCGCCATC
ACCACTGGGTCATTCCGCG -> CCACTGGGTCATTCCGCGT
TGGGCAGGTGGACGGAATC -> GGGCAGGTGGACGGAATCC
GGTCGGTTATGCCACTGGC -> GTCGGTTATGCCACTGGCG
TCAAACCCGGGTAAGAAGC -> CAAACCCGGGTAAGAAGCT
ACCTCGTACTTTGATGCGA -> CCTCGTACTTTGATGCGAT
GGCTGGGGAAAGCCAGTGT -> GCTGGGGAAAGCCAGTGTA
ATTATCCTGCTCAGCACCT -> TTATCCTGCTCAGCACCTG
GGCTCCCTTAGACAGTTTC -> GCTCCCTTAGACAGTTTCA
TGGCAGGCAAAGGAGCGTG -> GGCAGGCAAAGGAGCGTGT
GAGTTGCCGGCTGATAAGT -> AGTTGCCGGCTGATAAGTT
TTCTGATCAATGGAGCGCA -> TCTGATCAATGGAGCGCAG
GAAGCATGTATAGGCTCCC -> AAGCATGTATAGGCTCCCT
AACCATGTGAGGGCATGAG -> ACCATGTGAGGGCATGAGG
GCCCTGTGGAGAGACTCTG -> CCCTGTGGAGAGACTCTGG
TCGGGGCTAACCATGTGAG -> CGGGGCTAACCATGTGAGG
TCGATTCGCATCCTCGGTT -> CGATTCGCATCCTCGGTTG
GGGTCCTAGCGTTGGAAGA -> GGTCCTAGCGTTGGAAGAA
TACCGAGTAAGTCAGTATG -> ACCGAGTAAGTCAGTATGG
GTAACGTACCACTGAGATA -> TAACGTACCACTGAGATAT
ATTATCGATTCGCATCCTC -> TTATCGATTCGCATCCTCG
ACCCAATCATGAGTGAACA -> CCCAATCATGAGTGAACAT
GAGTAAGTCAGTATGGTTA -> AGTAAGTCAGTATGGTTAT
CAGTTTCAGTCGTCCGAAC -> AGTTTCAGTCGTCCGAACA
GGTCATTCCGCGTTTTTAA -> GTCATTCCGCGTTTTTAAG
CGACTACCCGGTTATGTTG -> GACTACCCGGTTATGTTGT
AATCTTCTTCGTCAGTCCC -> ATCTTCTTCGTCAGTCCCG
CCTTATTATCCTGCTGTTA -> CTTATTATCCTGCTGTTAC
GTGCGCATGACCCAATCAT -> TGCGCATGACCCAATCATG
AACAGCGTCCTGGATACTA -> ACAGCGTCCTGGATACTAA
TCATGAGTGAACATATGGA -> CATGAGTGAACATATGGAC
CCTTCCAGCCTGTCCCCTA -> CTTCCAGCCTGTCCCCTAA
AGTCGTGGCCAGTAGTCTA -> GTCGTGGCCAGTAGTCTAC
GAGTGGGCAGGTGGACGGA -> AGTGGGCAGGTGGACGGAA
CTTGATGCGACGTGTACAT -> TTGATGCGACGTGTACATT
GGGACAACAGAAGGGGGAC -> GGACAACAGAAGGGGGACC
TCCACAATCGTCGTGCCAA -> CCACAATCGTCGTGCCAAC
GTGGCCAGTAGTCTACCTA -> TGGCCAGTAGTCTACCTAG
GGCGACCTCGTACTTTGAT -> GCGACCTCGTACTTTGATG
CGGAAACAAGCTGCCAAAG -> GGAAACAAGCTGCCAAAGC
TTATCCTGCTACTGTCGTT -> TATCCTGCTACTGTCGTTG
AATAGATCACGCGAGACAG -> ATAGATCACGCGAGACAGT
TCATGCTTTCACGTCCCAT -> CATGCTTTCACGTCCCATA
CGACAACGTATAGTCGTGG -> GACAACGTATAGTCGTGGC
AGTAGTCTACCTAGCGACT -> GTAGTCTACCTAGCGACTA
TTATTATCCTGCTGTTACT -> TATTATCCTGCTGTTACTC
ATGAGTGAACATATGGACG -> TGAGTGAACATATGGACGG
AGACTCTGGTGCTGCGATC -> GACTCTGGTGCTGCGATCC
AGTAAGTCAGTATGGTTAT -> GTAAGTCAGTATGGTTATG
CGTACTTTGATGCGATGGG -> GTACTTTGATGCGATGGGG
CGGCCACGACCGCGTAAAC -> GGCCACGACCGCGTAAACA
TCTGGTGCTGCGATCCATG -> CTGGTGCTGCGATCCATGC
GCTTCGTCACGAACGATTT -> CTTCGTCACGAACGATTTA
GCCTTGTAGGGTCGCCGGG -> CCTTGTAGGGTCGCCGGGC
AACGAATGGAGAGGCGCTC -> ACGAATGGAGAGGCGCTCC
TAGCGTGGCTTACTGCGCC -> AGCGTGGCTTACTGCGCCT
TTATCGATTCGCATCCTCG -> TATCGATTCGCATCCTCGG
GCCTGTCCCCTAACGCAAA -> CCTGTCCCCTAACGCAAAT
ATCACACTGGCTGGGGAAA -> TCACACTGGCTGGGGAAAG
AGAAGCTCTCCCTACTTAA -> GAAGCTCTCCCTACTTAAC
CGTGTACGAGAGGTCTGCT -> GTGTACGAGAGGTCTGCTA
GAACCTCGCACCAAGACTG -> AACCTCGCACCAAGACTGG
TGGAGCGCAGCTCATAGGT -> GGAGCGCAGCTCATAGGTG
CAACAGGCCTGTGGAGTGC -> AACAGGCCTGTGGAGTGCT
GATTGATATTTATCTCTAC -> ATTGATATTTATCTCTACC
GTCCTGGATACTAAATTAC -> TCCTGGATACTAAATTACC
CCGGAGTGGGCAGGTGGAC -> CGGAGTGGGCAGGTGGACG
ATCCTCGGTTGAAACGAAT -> TCCTCGGTTGAAACGAATG
ACCTCCCTGTTGAACGGGA -> CCTCCCTGTTGAACGGGAT
TGGTACGCCGACGTGGGCT -> GGTACGCCGACGTGGGCTA
ACAATCCCATGGTAATTCT -> CAATCCCATGGTAATTCTG
CCGGTTATGTTGTCACCAC -> CGGTTATGTTGTCACCACA
TTTTAAGTGTGTGTCCCCG -> TTTAAGTGTGTGTCCCCGC
TCCCGTAAGAACCCCGGAG -> CCCGTAAGAACCCCGGAGG
CGGCCGACCACTGGGTCAT -> GGCCGACCACTGGGTCATT
CGGGTACATTATCGATTCG -> GGGTACATTATCGATTCGC
GGCCAGTAGTCTACCTAGC -> GCCAGTAGTCTACCTAGCG
TAGTGATCGACGTTGTTGG -> AGTGATCGACGTTGTTGGT
TGAAGAGGTTTTTGTAAAG -> GAAGAGGTTTTTGTAAAGC
AGCCCGTTAGGTTTTAGTG -> GCCCGTTAGGTTTTAGTGG
TGGCCCTGCGTTGACCGCG -> GGCCCTGCGTTGACCGCGT
CCTTATTATCCTGCTCAGC -> CTTATTATCCTGCTCAGCA
CCTACTTAACCTGGGACGT -> CTACTTAACCTGGGACGTC
CGCAGCTCATAGGTGGCGT -> GCAGCTCATAGGTGGCGTG
AACGATTTAAAAGAACCCA -> ACGATTTAAAAGAACCCAG
CGTTACGTGTCGTGTACGA -> GTTACGTGTCGTGTACGAG
CGGAATCCTACAATCCCAT -> GGAATCCTACAATCCCATG
AGCGTTGGAAGAAGCTGGG -> GCGTTGGAAGAAGCTGGGC
GTATAGTCGTGGCCAGTAG -> TATAGTCGTGGCCAGTAGT
CTTCACTCGCCCTGTGGAG -> TTCACTCGCCCTGTGGAGA
TATGTAAGAGAGCTAGATT -> ATGTAAGAGAGCTAGATTC
GGGAAAGCCAGTGTAGCGT -> GGAAAGCCAGTGTAGCGTG
CCCGTAAGAACCCCGGAGG -> CCGTAAGAACCCCGGAGGT
GCAATTGGCCCTGCGTTGA -> CAATTGGCCCTGCGTTGAC
GAGGTCTGCTATGAGAATA -> AGGTCTGCTATGAGAATAC
CGCATCCTCGGTTGAAACG -> GCATCCTCGGTTGAAACGA
CTAGTCGTCCTTATTATCC -> TAGTCGTCCTTATTATCCT
AAAGCCCAACCGTCAATCT -> AAGCCCAACCGTCAATCTT
CACGACCGCGTAAACACGA -> ACGACCGCGTAAACACGAG
CCTTATTATCCTGCTTGAT -> CTTATTATCCTGCTTGATG
GGACAACAGAAGGGGGACC -> GACAACAGAAGGGGGACCT
TAGGTGTGTACGTACGTAA -> AGGTGTGTACGTACGTAAT
GAATACTCTGAGAGATTCT -> AATACTCTGAGAGATTCTA
CGTTGTGTACATTATCGAT -> GTTGTGTACATTATCGATT
CTTTGATGCGATGGGGTCC -> TTTGATGCGATGGGGTCCT
GGTACATTATCGATTCGCA -> GTACATTATCGATTCGCAT
ACGAACGATTTAAAAGAAC -> CGAACGATTTAAAAGAACC
CGCGTATTTTGTGTTTATA -> GCGTATTTTGTGTTTATAA
GCTAAGATTAGAACCTCGC -> CTAAGATTAGAACCTCGCA
GCTGTGCTCCCTCGCCCTC -> CTGTGCTCCCTCGCCCTCA
AATGGAGCGCAGCTCATAG -> ATGGAGCGCAGCTCATAGG
ACACTGGCTGGGGAAAGCC -> CACTGGCTGGGGAAAGCCA
TTTCCTCTTTGATTAAACT -> TTCCTCTTTGATTAAACTT
TATGCCACTGGCGACCTCG -> ATGCCACTGGCGACCTCGT
TTTGATGCGATGGGGTCCT -> TTGATGCGATGGGGTCCTA
ATTGGTACGCCGACGTGGG -> TTGGTACGCCGACGTGGGC
GAAAATACCTAGAACCCAC -> AAAATACCTAGAACCCACA
CCAAGAGACTATCTTCACT -> CAAGAGACTATCTTCACTC
TGTGAGGGCATGAGGGTGT -> GTGAGGGCATGAGGGTGTG
GTGAGTGCCACCTTTCGGG -> TGAGTGCCACCTTTCGGGT
CCTAACGCAAATATCCGTC -> CTAACGCAAATATCCGTCC
TCAGTATGGTTATGTCCAT -> CAGTATGGTTATGTCCATC
CGTCCTGGATACTAAATTA -> GTCCTGGATACTAAATTAC
CTGAAGCATGTATAGGCTC -> TGAAGCATGTATAGGCTCC
TAAGCTGTAGCGTCCTTAT -> AAGCTGTAGCGTCCTTATT
TGCTTTCACGTCCCATAAA -> GCTTTCACGTCCCATAAAT
TGCAGCAGAGGCGTTACGT -> GCAGCAGAGGCGTTACGTG
TGCCTCCAGTGCGATTCTT -> GCCTCCAGTGCGATTCTTA
AAAGGAGCGTGTTACGGTC -> AAGGAGCGTGTTACGGTCA
CGTCCCATAAATATTGTCA -> GTCCCATAAATATTGTCAT
ACCTAGTCGTCCTTATTAT -> CCTAGTCGTCCTTATTATC
GGGCTTGATTACCGAGTAA -> GGCTTGATTACCGAGTAAG
AGGGACAACAGAAGGGGGA -> GGGACAACAGAAGGGGGAC
CAGCGTCCTGGATACTAAA -> AGCGTCCTGGATACTAAAT
GCCAAGAGACTATCTTCAC -> CCAAGAGACTATCTTCACT
GGGTATCTATTGGTACGCC -> GGTATCTATTGGTACGCCG
AACGTATAGTCGTGGCCAG -> ACGTATAGTCGTGGCCAGT
GTAAGAACCCCGGAGGTTC -> TAAGAACCCCGGAGGTTCA
AACCCCCTGGCAAACAACC -> ACCCCCTGGCAAACAACCG
CCAGCCTGTCCCCTAACGC -> CAGCCTGTCCCCTAACGCA
CTGGGCTGCTTCGTCACGA -> TGGGCTGCTTCGTCACGAA
GCTCCCTTAGACAGTTTCA -> CTCCCTTAGACAGTTTCAG
ACGTATAGTCGTGGCCAGT -> CGTATAGTCGTGGCCAGTA
TGGTGGTATGTAAGAGAGC -> GGTGGTATGTAAGAGAGCT
CACATGCATCCACAATCGT -> ACATGCATCCACAATCGTC
TAACCTGGGACGTCCTTAT -> AACCTGGGACGTCCTTATT
CCCGGGTAAGAAGCTCTCC -> CCGGGTAAGAAGCTCTCCC
TCGTCAAGTTGGGGCACAG -> CGTCAAGTTGGGGCACAGC
CCGCGACTAAAGCGTCGAG -> CGCGACTAAAGCGTCGAGC
GCAAATATCCGTCCTTATT -> CAAATATCCGTCCTTATTA
AGGTCTGCTATGAGAATAC -> GGTCTGCTATGAGAATACT
AACCGGAGTGGGCAGGTGG -> ACCGGAGTGGGCAGGTGGA
TAAAGCCCGTTAGGTTTTA -> AAAGCCCGTTAGGTTTTAG
CAATCATGAGTGAACATAT -> AATCATGAGTGAACATATG
AGCGTCCTGGATACTAAAT -> GCGTCCTGGATACTAAATT
GTAAACACGAGCTAGTGAT -> TAAACACGAGCTAGTGATC
TCCATTACGCCAAGAGACT -> CCATTACGCCAAGAGACTA
GCGACGTGTACATTATCGA -> CGACGTGTACATTATCGAT
TTCAGTCGTCCGAACACAC -> TCAGTCGTCCGAACACACC
CGTTGGAAGAAGCTGGGCT -> GTTGGAAGAAGCTGGGCTG
CCACCGCTGCATCGTGTCC -> CACCGCTGCATCGTGTCCG
TATGTTGTCACCACATGCA -> ATGTTGTCACCACATGCAT
ACAACAGAAGGGGGACCTG -> CAACAGAAGGGGGACCTGC
ATTGCTTCTGTACGGGTCT -> TTGCTTCTGTACGGGTCTG
TCGCCCTCAGTGTATGACG -> CGCCCTCAGTGTATGACGG
ACATTATCGATTCGCATTC -> CATTATCGATTCGCATTCT,CATTATCGATTCGCATTCC
TCTACCCACCGCTGCATCG -> CTACCCACCGCTGCATCGT
CACGCGAGACAGTGAGTGC -> ACGCGAGACAGTGAGTGCC
ACGTGTACATTATCGATTC -> CGTGTACATTATCGATTCG
GATGAAGGTCGGTTATGCC -> ATGAAGGTCGGTTATGCCA
CTTCCAGCCTGTCCCCTAA -> TTCCAGCCTGTCCCCTAAC
TTGAAAATACCTAGAACCC -> TGAAAATACCTAGAACCCA
TAACCATGTGAGGGCATGA -> AACCATGTGAGGGCATGAG
GTGGCAATTGCTTCTGTAC -> TGGCAATTGCTTCTGTACG
GCTAGTGCGTGGTACATAG -> CTAGTGCGTGGTACATAGT
CTATTGGTACGCCGACGTG -> TATTGGTACGCCGACGTGG
CTGGTGCTGCGATCCATGC -> TGGTGCTGCGATCCATGCT
ACCGCGTATTTTGTGTTTA -> CCGCGTATTTTGTGTTTAT
TCCCTCGCCCTCAGTGTAT -> CCCTCGCCCTCAGTGTATG
TTTTTCCATTAGATTCGTG -> TTTTCCATTAGATTCGTGC
CGGCGGGGGTATCTATTGG -> GGCGGGGGTATCTATTGGT
CGTGTTACGGTCATAACAT -> GTGTTACGGTCATAACATG
AGCTAGATTCAGGCTGTGC -> GCTAGATTCAGGCTGTGCT
CCCTCAGTGTATGACGGCC -> CCTCAGTGTATGACGGCCG
CTGATAAGTTTCCTCTTTG -> TGATAAGTTTCCTCTTTGA
GGCTTACTGCGCCTTGTAG -> GCTTACTGCGCCTTGTAGG
TGCTTGATGCGACGTGTAC -> GCTTGATGCGACGTGTACA
AGTACATTATCGATTCGCA -> GTACATTATCGATTCGCAT
GGTAATGCCAAGCGTTACC -> GTAATGCCAAGCGTTACCT
CTGCTATGAGAATACTCTG -> TGCTATGAGAATACTCTGA
GAGCGGGCTCATGCTTTCA -> AGCGGGCTCATGCTTTCAC
GGCACAGCTGACTCGAGTT -> GCACAGCTGACTCGAGTTG
GCGCATACGTATTATCATC -> CGCATACGTATTATCATCG
GCAGCAGAGGCGTTACGTG -> CAGCAGAGGCGTTACGTGT
GGCGTTGACTACGACCTAG -> GCGTTGACTACGACCTAGT
GATTCGCATCCTCGGTTGA -> ATTCGCATCCTCGGTTGAA
CTCGCCCTGTGGAGAGACT -> TCGCCCTGTGGAGAGACTC
ACCAAACCCCCTGGCAAAC -> CCAAACCCCCTGGCAAACA
CCGGGTAAGAAGCTCTCCC -> CGGGTAAGAAGCTCTCCCT
GCCGACCACTGGGTCATTC -> CCGACCACTGGGTCATTCC
AAGATTAGAACCTCGCACC -> AGATTAGAACCTCGCACCA
ATGTCAGTCGGTCTTAGGC -> TGTCAGTCGGTCTTAGGCA
GACAACAGAAGGGGGACCT -> ACAACAGAAGGGGGACCTG
ACAATCGTCGTGCCAACCT -> CAATCGTCGTGCCAACCTC
TGTCCCCTAACGCAAATAT -> GTCCCCTAACGCAAATATC
GTGTACATTATCGATTCGC -> TGTACATTATCGATTCGCA,TGTACATTATCGATTCGCA
TACGTGTCGTGTACGAGAG -> ACGTGTCGTGTACGAGAGG
ACATGGCAATTGGCCCTGC -> CATGGCAATTGGCCCTGCG
GAGAATACTCTGAGAGATT -> AGAATACTCTGAGAGATTC
GGGTAATGCCAAGCGTTAC -> GGTAATGCCAAGCGTTACC
GTGCTTGCTACTGAAATGT -> TGCTTGCTACTGAAATGTC
ACAGAAGATGGCAGGCAAA -> CAGAAGATGGCAGGCAAAG
GTTTTTCCATTAGATTCGT -> TTTTTCCATTAGATTCGTG
AAGACTGGGGGTCCTCGTA -> AGACTGGGGGTCCTCGTAG
AAGAGAGCTAGATTCAGGC -> AGAGAGCTAGATTCAGGCT
AGGTGGACGGAATCCTACA -> GGTGGACGGAATCCTACAA
TAACGTACCACTGAGATAT -> AACGTACCACTGAGATATA
CGCCGACTTAGGTTGGTAT -> GCCGACTTAGGTTGGTATT
AGAGCTAGATTCAGGCTGT -> GAGCTAGATTCAGGCTGTG
AAGGATAGCTCGGAGCTCT -> AGGATAGCTCGGAGCTCTT
TTTTTGTAAAGCCCGTTAG -> TTTTGTAAAGCCCGTTAGG
TCGGTTACATCTCGGGATA -> CGGTTACATCTCGGGATAC
GACTACCCGGTTATGTTGT -> ACTACCCGGTTATGTTGTC
GGCTAACCATGTGAGGGCA -> GCTAACCATGTGAGGGCAT
ATCCTACAATCCCATGGTA -> TCCTACAATCCCATGGTAA
AATGGAGAGGCGCTCCCCA -> ATGGAGAGGCGCTCCCCAT
AGACTATCTTCACTCGCCC -> GACTATCTTCACTCGCCCT
GATTCGCATTGTGTGTTTT -> ATTCGCATTGTGTGTTTTT
TTGATTAAACTTAGTTAGG -> TGATTAAACTTAGTTAGGT
GTTGACTACGACCTAGTCG -> TTGACTACGACCTAGTCGT
TCCCCTAACGCAAATATCC -> CCCCTAACGCAAATATCCG
GAACCCAGGTGTTACCACA -> AACCCAGGTGTTACCACAG
CTCCCCATATCGCCATCAG -> TCCCCATATCGCCATCAGA
GGCCACGACCGCGTAAACA -> GCCACGACCGCGTAAACAC
CTGCAGCAGAGGCGTTACG -> TGCAGCAGAGGCGTTACGT
GGACCATCATATTAAAGTT -> GACCATCATATTAAAGTTA
CTAGATTCAGGCTGTGCTC -> TAGATTCAGGCTGTGCTCC
GACTACGACCTAGTCGTCC -> ACTACGACCTAGTCGTCCT
TCCTGATTGCGCATACGTA -> CCTGATTGCGCATACGTAT
CCGTTAGGTTTTAGTGGAC -> CGTTAGGTTTTAGTGGACC
TCGGTTATGCCACTGGCGA -> CGGTTATGCCACTGGCGAC
CGACCAAACCCCCTGGCAA -> GACCAAACCCCCTGGCAAA
CTCGCCCTCAGTGTATGAC -> TCGCCCTCAGTGTATGACG
TCATCGCGGTATTCAAAAT -> CATCGCGGTATTCAAAATG
ATTCAGGCTGTGCTCCCTC -> TTCAGGCTGTGCTCCCTCG
CGTGGCCAGTAGTCTACCT -> GTGGCCAGTAGTCTACCTA
CATAGGTGGCGTGCGCATG -> ATAGGTGGCGTGCGCATGA
TGTACATTATCGATTCGCA -> GTACATTATCGATTCGCAT,GTACATTATCGATTCGCAT
ATGCGATGGGGTCCTAGCG -> TGCGATGGGGTCCTAGCGT
CGTTGACCGCGTATTTTGT -> GTTGACCGCGTATTTTGTG
GATCAATGGAGCGCAGCTC -> ATCAATGGAGCGCAGCTCA
CGCATTGTGTGTTTTTCCA -> GCATTGTGTGTTTTTCCAT
CACCACATGCATCCACAAT -> ACCACATGCATCCACAATC
CAGAAGATATCGGTTACAT -> AGAAGATATCGGTTACATC
TCAGTCGGTCTTAGGCATT -> CAGTCGGTCTTAGGCATTC
CTGGGACGTCCTTATTATC -> TGGGACGTCCTTATTATCC
AGCGCAGCTCATAGGTGGC -> GCGCAGCTCATAGGTGGCG
CATCAGAAGATATCGGTTA -> ATCAGAAGATATCGGTTAC
CGCGACTAAAGCGTCGAGC -> GCGACTAAAGCGTCGAGCG
GAGTACATTATCGATTCGC -> AGTACATTATCGATTCGCA
TATTATCCTGCTTGATGCG -> ATTATCCTGCTTGATGCGA
GTAAGAGAGCTAGATTCAG -> TAAGAGAGCTAGATTCAGG
TCAAAATGAAGAGGTTTTT -> CAAAATGAAGAGGTTTTTG
CACCGGCGTTGACTACGAC -> ACCGGCGTTGACTACGACC
ATTCCGCGTTTTTAAGTGT -> TTCCGCGTTTTTAAGTGTG
CAGTGCTGCAGCAGAGGCG -> AGTGCTGCAGCAGAGGCGT
GGATACCTGCGCCGCGATA -> GATACCTGCGCCGCGATAT
TTATGCTCGACCACCGCGG -> TATGCTCGACCACCGCGGC
ATTCCTGATTGCGCATACG -> TTCCTGATTGCGCATACGT
CGACTTAGGTTGGTATTCT -> GACTTAGGTTGGTATTCTG
AGACAGTTTCAGTCGTCCG -> GACAGTTTCAGTCGTCCGA
CCGGCCACGACCGCGTAAA -> CGGCCACGACCGCGTAAAC
GATTCAGGCTGTGCTCCCT -> ATTCAGGCTGTGCTCCCTC
GTTACCTTCCAGCCTGTCC -> TTACCTTCCAGCCTGTCCC
GCGTTGGAAGAAGCTGGGC -> CGTTGGAAGAAGCTGGGCT
GTGCTGCGATCCATGCTCG -> TGCTGCGATCCATGCTCGT
ATCCGTCCTTATTATCCTG -> TCCGTCCTTATTATCCTGC
GTCGGTTATGCCACTGGCG -> TCGGTTATGCCACTGGCGA
CCTTCTATTTGAGTTCATC -> CTTCTATTTGAGTTCATCA
GGCAATTGGCCCTGCGTTG -> GCAATTGGCCCTGCGTTGA
GGTCCTCGTAGCCATCGAC -> GTCCTCGTAGCCATCGACA
TCTTATGCCCTATCGACGT -> CTTATGCCCTATCGACGTT
TAGGTTTTAGTGGACCATC -> AGGTTTTAGTGGACCATCA
GAGAGATTCTATTGAAAAT -> AGAGATTCTATTGAAAATA
GCCCGTTAGGTTTTAGTGG -> CCCGTTAGGTTTTAGTGGA
CTTGATTACCGAGTAAGTC -> TTGATTACCGAGTAAGTCA
CTCCCGGGTACATTATCGA -> TCCCGGGTACATTATCGAT
CCTGCTTGATGCGACGTGT -> CTGCTTGATGCGACGTGTA
TAACATGGCAATTGGCCCT -> AACATGGCAATTGGCCCTG
CGGGGGTATCTATTGGTAC -> GGGGGTATCTATTGGTACG
TAGATTGATATTTATCTCT -> AGATTGATATTTATCTCTA
ACCGCGGCGGGGGTATCTA -> CCGCGGCGGGGGTATCTAT
CCAAACCCCCTGGCAAACA -> CAAACCCCCTGGCAAACAA
AACACGAGCTAGTGATCGA -> ACACGAGCTAGTGATCGAC
ACGACAACGTATAGTCGTG -> CGACAACGTATAGTCGTGG
GGTGTGTACGTACGTAATG -> GTGTGTACGTACGTAATGC
GTCAATCTTCTTCGTCAGT -> TCAATCTTCTTCGTCAGTC
GACTATCTTCACTCGCCCT -> ACTATCTTCACTCGCCCTG
GATTGCGCATACGTATTAT -> ATTGCGCATACGTATTATC
ATCCACAATCGTCGTGCCA -> TCCACAATCGTCGTGCCAA
AATGCCAAGCGTTACCTTC -> ATGCCAAGCGTTACCTTCC
CCGCGTATTTTGTGTTTAT -> CGCGTATTTTGTGTTTATA
GATTAAACTTAGTTAGGTG -> ATTAAACTTAGTTAGGTGG
GGTACGCCGACGTGGGCTA -> GTACGCCGACGTGGGCTAG
AGGCAAAGGAGCGTGTTAC -> GGCAAAGGAGCGTGTTACG
GCGCCGCGATATACAAGGA -> CGCCGCGATATACAAGGAT
TACCTGCGCCGCGATATAC -> ACCTGCGCCGCGATATACA
GCGTCCTGGATACTAAATT -> CGTCCTGGATACTAAATTA
GTAACCCCCCCTGCAGGAT -> TAACCCCCCCTGCAGGATT
TTCAAAATGAAGAGGTTTT -> TCAAAATGAAGAGGTTTTT
TAGAACCTCGCACCAAGAC -> AGAACCTCGCACCAAGACT
CTCTGGTGCTGCGATCCAT -> TCTGGTGCTGCGATCCATG
AATTACCCAGAAGTCAAAC -> ATTACCCAGAAGTCAAACC
GTGGGCAGGTGGACGGAAT -> TGGGCAGGTGGACGGAATC
ACGTGTCGTGTACGAGAGG -> CGTGTCGTGTACGAGAGGT
ATGTTAGATTGATATTTAT -> TGTTAGATTGATATTTATC
CGTGTCGTGTACGAGAGGT -> GTGTCGTGTACGAGAGGTC
AAAAGAACCCAGGTGTTAC -> AAAGAACCCAGGTGTTACC
AACCTCCCTGTTGAACGGG -> ACCTCCCTGTTGAACGGGA
AGCACCTGGAGTACATTAT -> GCACCTGGAGTACATTATC
AGAAGTCAAACCCGGGTAA -> GAAGTCAAACCCGGGTAAG
TGGACCATCATATTAAAGT -> GGACCATCATATTAAAGTT
GAAGGGGGACCTGCCCGGC -> AAGGGGGACCTGCCCGGCC
TCTTTGATTAAACTTAGTT -> CTTTGATTAAACTTAGTTA
GGTGGCGTGCGCATGACCC -> GTGGCGTGCGCATGACCCA
TGATCAATGGAGCGCAGCT -> GATCAATGGAGCGCAGCTC
AGAGGTTTTTGTAAAGCCC -> GAGGTTTTTGTAAAGCCCG
CTCGCACCAAGACTGGGGG -> TCGCACCAAGACTGGGGGT
CGTGTACATTATCGATTCG -> GTGTACATTATCGATTCGC
GCGGGCTCATGCTTTCACG -> CGGGCTCATGCTTTCACGT
GGCAAAGGAGCGTGTTACG -> GCAAAGGAGCGTGTTACGG
TCGGGATACCTGCGCCGCG -> CGGGATACCTGCGCCGCGA
TCGTCAGTCCCGTAAGAAC -> CGTCAGTCCCGTAAGAACC
CGTCCTTATTATCCTGCTT -> GTCCTTATTATCCTGCTTG
CGCCAAGAGACTATCTTCA -> GCCAAGAGACTATCTTCAC
TTCTTATGCCCTATCGACG -> TCTTATGCCCTATCGACGT
TGTACGTACGTAATGCCTC -> GTACGTACGTAATGCCTCC
TTAGTGGACCATCATATTA -> TAGTGGACCATCATATTAA
TACATTATCGATTCGCATC -> ACATTATCGATTCGCATCC
GGTTATGTCCATCGTAACG -> GTTATGTCCATCGTAACGT
AGGTGGGGTGGCAATTGCT -> GGTGGGGTGGCAATTGCTT
GTACTTTGATGCGATGGGG -> TACTTTGATGCGATGGGGT
ACGTACGTAATGCCTCCAG -> CGTACGTAATGCCTCCAGT
AGTCAGTATGGTTATGTCC -> GTCAGTATGGTTATGTCCA
TCACCACATGCATCCACAA -> CACCACATGCATCCACAAT
GAACGATTTAAAAGAACCC -> AACGATTTAAAAGAACCCA
CAGGCCTGTGGAGTGCTTG -> AGGCCTGTGGAGTGCTTGC
AAACACGAGCTAGTGATCG -> AACACGAGCTAGTGATCGA
ACGTTGTTGGTGGTATGTA -> CGTTGTTGGTGGTATGTAA
CGTATAGTCGTGGCCAGTA -> GTATAGTCGTGGCCAGTAG
CATGGTAATTCTGATCAAT -> ATGGTAATTCTGATCAATG
TGCAGGATTATTTTATTCT -> GCAGGATTATTTTATTCTA
CTGCATCGTGTCCGCCGAC -> TGCATCGTGTCCGCCGACT
CTAACCATGTGAGGGCATG -> TAACCATGTGAGGGCATGA
CAAGACTGGGGGTCCTCGT -> AAGACTGGGGGTCCTCGTA
GCGGTATTCAAAATGAAGA -> CGGTATTCAAAATGAAGAG
GACGTGTACATTATCGATT -> ACGTGTACATTATCGATTC
CTTAGGTTGGTATTCTGAA -> TTAGGTTGGTATTCTGAAG
TGGCAATTGGCCCTGCGTT -> GGCAATTGGCCCTGCGTTG
TCCAGCCTGTCCCCTAACG -> CCAGCCTGTCCCCTAACGC
TGGGGGTCCTCGTAGCCAT -> GGGGGTCCTCGTAGCCATC
CCAACCTCCCTGTTGAACG -> CAACCTCCCTGTTGAACGG
CATTCCTGATTGCGCATAC -> ATTCCTGATTGCGCATACG
CAGTCGTCCGAACACACCG -> AGTCGTCCGAACACACCGG
GTACGTAATGCCTCCAGTG -> TACGTAATGCCTCCAGTGC
GGTCGCCGGGCTTGATTAC -> GTCGCCGGGCTTGATTACC
GTGCTGCAGCAGAGGCGTT -> TGCTGCAGCAGAGGCGTTA
CATTCCGCGTTTTTAAGTG -> ATTCCGCGTTTTTAAGTGT
CGGGCTTGATTACCGAGTA -> GGGCTTGATTACCGAGTAA
ATCTCTACCCACCGCTGCA -> TCTCTACCCACCGCTGCAT
CCCTGTTGAACGGGATGAA -> CCTGTTGAACGGGATGAAG
CTCCCTGTTGAACGGGATG -> TCCCTGTTGAACGGGATGA
GAGGCGCTCCCCATATCGC -> AGGCGCTCCCCATATCGCC
GCATGAGGGTGTGCCGCGA -> CATGAGGGTGTGCCGCGAC
CGGTTGAAACGAATGGAGA -> GGTTGAAACGAATGGAGAG
CCACAGAAGATGGCAGGCA -> CACAGAAGATGGCAGGCAA
ATCCCATGGTAATTCTGAT -> TCCCATGGTAATTCTGATC
GCGACTAAAGCGTCGAGCG -> CGACTAAAGCGTCGAGCGG
TGCGATGGGGTCCTAGCGT -> GCGATGGGGTCCTAGCGTT
TAGGGTCGCCGGGCTTGAT -> AGGGTCGCCGGGCTTGATT
TGGGGAAAGCCAGTGTAGC -> GGGGAAAGCCAGTGTAGCG
TTTTTAAGTGTGTGTCCCC -> TTTTAAGTGTGTGTCCCCG
CTAGTGATCGACGTTGTTG -> TAGTGATCGACGTTGTTGG
CAGGCAAAGGAGCGTGTTA -> AGGCAAAGGAGCGTGTTAC
GGACGTCCTTATTATCCTG -> GACGTCCTTATTATCCTGC
TTGGTGGTATGTAAGAGAG -> TGGTGGTATGTAAGAGAGC
TAATGCCAAGCGTTACCTT -> AATGCCAAGCGTTACCTTC
TATGCTCGACCACCGCGGC -> ATGCTCGACCACCGCGGCG
TGCATCGTGTCCGCCGACT -> GCATCGTGTCCGCCGACTT
TATCGATTCGCATCCTCGG -> ATCGATTCGCATCCTCGGT
CCGCGTTTTTAAGTGTGTG -> CGCGTTTTTAAGTGTGTGT
TATCGGTTACATCTCGGGA -> ATCGGTTACATCTCGGGAT
CTTTCGGGTAATGCCAAGC -> TTTCGGGTAATGCCAAGCG
CTCAGCACCTGGAGTACAT -> TCAGCACCTGGAGTACATT
TCGGGTAATGCCAAGCGTT -> CGGGTAATGCCAAGCGTTA
AGCTGTAGCGTCCTTATTA -> GCTGTAGCGTCCTTATTAT
GTAGTCTACCTAGCGACTA -> TAGTCTACCTAGCGACTAC
CAGCCTGTCCCCTAACGCA -> AGCCTGTCCCCTAACGCAA
GTCATAGGTGTGTACGTAC -> TCATAGGTGTGTACGTACG
CCTCTTTGATTAAACTTAG -> CTCTTTGATTAAACTTAGT
ACCGTCAATCTTCTTCGTC -> CCGTCAATCTTCTTCGTCA
GCGTGTTACGGTCATAACA -> CGTGTTACGGTCATAACAT
CCTCGCACCAAGACTGGGG -> CTCGCACCAAGACTGGGGG
GACCACTGGGTCATTCCGC -> ACCACTGGGTCATTCCGCG
ACAACCGGAGTGGGCAGGT -> CAACCGGAGTGGGCAGGTG
TTCTTAGGACGGGTGCCTT -> TCTTAGGACGGGTGCCTTC
TTAGACAGTTTCAGTCGTC -> TAGACAGTTTCAGTCGTCC
AACCCACAATCACTCCATT -> ACCCACAATCACTCCATTA
ATGGTAATTCTGATCAATG -> TGGTAATTCTGATCAATGG
GTTGAAACGAATGGAGAGG -> TTGAAACGAATGGAGAGGC
TCGTACTTTGATGCGATGG -> CGTACTTTGATGCGATGGG
TGCCCGGCCACGACCGCGT -> GCCCGGCCACGACCGCGTA
CTTCGTCAGTCCCGTAAGA -> TTCGTCAGTCCCGTAAGAA
TGGTATGTAAGAGAGCTAG -> GGTATGTAAGAGAGCTAGA
TGGGTCATTCCGCGTTTTT -> GGGTCATTCCGCGTTTTTA
CGTAACGTACCACTGAGAT -> GTAACGTACCACTGAGATA
AGCATGTATAGGCTCCCTT -> GCATGTATAGGCTCCCTTA
CGTTACCTTCCAGCCTGTC -> GTTACCTTCCAGCCTGTCC
TGCCAAAGCCCAACCGTCA -> GCCAAAGCCCAACCGTCAA
TCAATCTTCTTCGTCAGTC -> CAATCTTCTTCGTCAGTCC
GAGGGACAACAGAAGGGGG -> AGGGACAACAGAAGGGGGA
ATGGAGAGGCGCTCCCCAT -> TGGAGAGGCGCTCCCCATA
TTATCTCTACCCACCGCTG -> TATCTCTACCCACCGCTGC
GACGGGTGCCTTCTATTTG -> ACGGGTGCCTTCTATTTGA
TGTACGAGAGGTCTGCTAT -> GTACGAGAGGTCTGCTATG
AAACGAATGGAGAGGCGCT -> AACGAATGGAGAGGCGCTC
TATTATCCTGCTCAGCACC -> ATTATCCTGCTCAGCACCT
TTCGCCACCAGCCCTCTGA -> TCGCCACCAGCCCTCTGAC
ACCCACAATCACTCCATTA -> CCCACAATCACTCCATTAC
TTCACGTCCCATAAATATT -> TCACGTCCCATAAATATTG
AAATATTGTCATAGGTGTG -> AATATTGTCATAGGTGTGT
ACGGAATCCTACAATCCCA -> CGGAATCCTACAATCCCAT
GCTGCTTCGTCACGAACGA -> CTGCTTCGTCACGAACGAT
ATCCTGCTTGATGCGACGT -> TCCTGCTTGATGCGACGTG
GGGGAAAGCCAGTGTAGCG -> GGGAAAGCCAGTGTAGCGT
CAGCAGAGGCGTTACGTGT -> AGCAGAGGCGTTACGTGTC
CTGGGGAAAGCCAGTGTAG -> TGGGGAAAGCCAGTGTAGC
GACTGGGGGTCCTCGTAGC -> ACTGGGGGTCCTCGTAGCC
CATCACACTGGCTGGGGAA -> ATCACACTGGCTGGGGAAA
GGACGGGTGCCTTCTATTT -> GACGGGTGCCTTCTATTTG
TCTCTACCCACCGCTGCAT -> CTCTACCCACCGCTGCATC
CTGTCGTTGTGTACATTAT -> TGTCGTTGTGTACATTATC
TGGACGGAAACAAGCTGCC -> GGACGGAAACAAGCTGCCA
GACGTGGGCTAGTGCGTGG -> ACGTGGGCTAGTGCGTGGT
TCACTCCATTACGCCAAGA -> CACTCCATTACGCCAAGAG
TTCTATTGAAAATACCTAG -> TCTATTGAAAATACCTAGA
CAATCACTCCATTACGCCA -> AATCACTCCATTACGCCAA
AAACAGCGTCCTGGATACT -> AACAGCGTCCTGGATACTA
TGGGCTAGTGCGTGGTACA -> GGGCTAGTGCGTGGTACAT
GCAATTGCTTCTGTACGGG -> CAATTGCTTCTGTACGGGT
TACATTATCGATTCGCATT -> ACATTATCGATTCGCATTC,ACATTATCGATTCGCATTC,ACATTATCGATTCGCATTG
ACGCCAAGAGACTATCTTC -> CGCCAAGAGACTATCTTCA
CGTACCACTGAGATATACT -> GTACCACTGAGATATACTG
GGTATTCTGAAGCATGTAT -> GTATTCTGAAGCATGTATA
CTGGCGACCTCGTACTTTG -> TGGCGACCTCGTACTTTGA
TAGCGACTACCCGGTTATG -> AGCGACTACCCGGTTATGT
ACAGCGTCCTGGATACTAA -> CAGCGTCCTGGATACTAAA
GAGGCGTTACGTGTCGTGT -> AGGCGTTACGTGTCGTGTA
CGTTTTTAAGTGTGTGTCC -> GTTTTTAAGTGTGTGTCCC
AACTTAGTTAGGTGGGGTG -> ACTTAGTTAGGTGGGGTGG
GTCCGCCGACTTAGGTTGG -> TCCGCCGACTTAGGTTGGT
CTGTACGGGTCTGGTGGCC -> TGTACGGGTCTGGTGGCCG
ATGAGGGTGTGCCGCGACT -> TGAGGGTGTGCCGCGACTA
TTGGCCCTGCGTTGACCGC -> TGGCCCTGCGTTGACCGCG
CGAGACAGTGAGTGCCACC -> GAGACAGTGAGTGCCACCT
TTTTATTCTAGGCATTATG -> TTTATTCTAGGCATTATGC
TGATTGCGCATACGTATTA -> GATTGCGCATACGTATTAT
TCGCATCCTCGGTTGAAAC -> CGCATCCTCGGTTGAAACG
TTGAGTTCATCACACTGGC -> TGAGTTCATCACACTGGCT
AGGCCTGTGGAGTGCTTGC -> GGCCTGTGGAGTGCTTGCT
ACCGAGTAAGTCAGTATGG -> CCGAGTAAGTCAGTATGGT
GAGGTTCAAGTATTCGGGG -> AGGTTCAAGTATTCGGGGC
TCCTTATTATCCTGCTACT -> CCTTATTATCCTGCTACTG
AAACTTAGTTAGGTGGGGT -> AACTTAGTTAGGTGGGGTG
CCTAGAACCCACAATCACT -> CTAGAACCCACAATCACTC
GTCACCACATGCATCCACA -> TCACCACATGCATCCACAA
AGCGTCGAGCGGGCTCATG -> GCGTCGAGCGGGCTCATGC
ATCGATTCGCATTCTTAGG -> TCGATTCGCATTCTTAGGA
CTGAGGGACAACAGAAGGG -> TGAGGGACAACAGAAGGGG
GGCTGCTTCGTCACGAACG -> GCTGCTTCGTCACGAACGA
GGGTGCCTTCTATTTGAGT -> GGTGCCTTCTATTTGAGTT
TGCTATGAGAATACTCTGA -> GCTATGAGAATACTCTGAG
CCCCTGCAGGATTATTTTA -> CCCTGCAGGATTATTTTAT
TCCTTATTATCCTGCTTGA -> CCTTATTATCCTGCTTGAT
GGTTCAAGTATTCGGGGCT -> GTTCAAGTATTCGGGGCTA
GTGTTTATAAGCTGTAGCG -> TGTTTATAAGCTGTAGCGT
GTTGGGGCACAGCTGACTC -> TTGGGGCACAGCTGACTCG
CGTTGACTACGACCTAGTC -> GTTGACTACGACCTAGTCG
ACCGCTGCATCGTGTCCGC -> CCGCTGCATCGTGTCCGCC
CGATTCGCATTGTGTGTTT -> GATTCGCATTGTGTGTTTT
ATTGCGCATACGTATTATC -> TTGCGCATACGTATTATCA
AAGTTACACAACAGGCCTG -> AGTTACACAACAGGCCTGT
TAGTGGACCATCATATTAA -> AGTGGACCATCATATTAAA
GCCGGCTGATAAGTTTCCT -> CCGGCTGATAAGTTTCCTC
TTACGTGTCGTGTACGAGA -> TACGTGTCGTGTACGAGAG
TGAGATATACTGAGGGACA -> GAGATATACTGAGGGACAA
GTCCATCGTAACGTACCAC -> TCCATCGTAACGTACCACT
TATGACGGCCGACCACTGG -> ATGACGGCCGACCACTGGG
CCCCGGAGGTTCAAGTATT -> CCCGGAGGTTCAAGTATTC
TCCCATAAATATTGTCATA -> CCCATAAATATTGTCATAG
GGGGTATCTATTGGTACGC -> GGGTATCTATTGGTACGCC
CACGTCCCATAAATATTGT -> ACGTCCCATAAATATTGTC
TGTGTTTATAAGCTGTAGC -> GTGTTTATAAGCTGTAGCG
TTCCGCGTTTTTAAGTGTG -> TCCGCGTTTTTAAGTGTGT
TCCTGGATACTAAATTACC -> CCTGGATACTAAATTACCC
ATTAGAACCTCGCACCAAG -> TTAGAACCTCGCACCAAGA
CATTATCGATTCGCATTCC -> ATTATCGATTCGCATTCCT
GACAGTTTCAGTCGTCCGA -> ACAGTTTCAGTCGTCCGAA
TTATCGATTCGCATTGTGT -> TATCGATTCGCATTGTGTG
AGTTACACAACAGGCCTGT -> GTTACACAACAGGCCTGTG
AGGATTATTTTATTCTAGG -> GGATTATTTTATTCTAGGC
CGAGCTAGTGATCGACGTT -> GAGCTAGTGATCGACGTTG
AAGTCAAACCCGGGTAAGA -> AGTCAAACCCGGGTAAGAA
GCGTCCTTATTATCCTGCT -> CGTCCTTATTATCCTGCTG
CTCTGACGACAACGTATAG -> TCTGACGACAACGTATAGT
GGGCAGGTGGACGGAATCC -> GGCAGGTGGACGGAATCCT
GGGACCTGCCCGGCCACGA -> GGACCTGCCCGGCCACGAC
TGTCGTTGTGTACATTATC -> GTCGTTGTGTACATTATCG
CTACTGAAATGTCAGTCGG -> TACTGAAATGTCAGTCGGT
ACTCCCGGGTACATTATCG -> CTCCCGGGTACATTATCGA
CCTATCGACGTTGCTTCCC -> CTATCGACGTTGCTTCCCT
GTGTGTCCCCGCGACCAAA -> TGTGTCCCCGCGACCAAAC
CTCGGGATACCTGCGCCGC -> TCGGGATACCTGCGCCGCG
TCTGGTGGCCGGTAAAAAC -> CTGGTGGCCGGTAAAAACA
TCTATGTTAGATTGATATT -> CTATGTTAGATTGATATTT
CTGGGTCATTCCGCGTTTT -> TGGGTCATTCCGCGTTTTT
GAGAGGTCTGCTATGAGAA -> AGAGGTCTGCTATGAGAAT
GTGCCACCTTTCGGGTAAT -> TGCCACCTTTCGGGTAATG
CACAATCGTCGTGCCAACC -> ACAATCGTCGTGCCAACCT
CCAGGTGTTACCACAGAAG -> CAGGTGTTACCACAGAAGA
GGTGCTGCGATCCATGCTC -> GTGCTGCGATCCATGCTCG
CTTATGCCCTATCGACGTT -> TTATGCCCTATCGACGTTG
GCACAGCTGACTCGAGTTG -> CACAGCTGACTCGAGTTGC
GTGGCCGGTAAAAACAGCG -> TGGCCGGTAAAAACAGCGT
TTATTATCCTGCTACTGTC -> TATTATCCTGCTACTGTCG
TTTCCATTAGATTCGTGCG -> TTCCATTAGATTCGTGCGT
CGTAACCCCCCCTGCAGGA -> GTAACCCCCCCTGCAGGAT
GGATAGCTCGGAGCTCTTA -> GATAGCTCGGAGCTCTTAC
TGTAAGAGAGCTAGATTCA -> GTAAGAGAGCTAGATTCAG
GACCACCGCGGCGGGGGTA -> ACCACCGCGGCGGGGGTAT
CATTATGCTCGACCACCGC -> ATTATGCTCGACCACCGCG
ATTATCGATTCGCATTGTG -> TTATCGATTCGCATTGTGT
GTGTAGCGTGGCTTACTGC -> TGTAGCGTGGCTTACTGCG
GTTGTGTACATTATCGATT -> TTGTGTACATTATCGATTC
GGGCATGAGGGTGTGCCGC -> GGCATGAGGGTGTGCCGCG
TACTGCGCCTTGTAGGGTC -> ACTGCGCCTTGTAGGGTCG
CCTCCAGTGCGATTCTTAT -> CTCCAGTGCGATTCTTATG
TGAAATGTCAGTCGGTCTT -> GAAATGTCAGTCGGTCTTA
TACTTTGATGCGATGGGGT -> ACTTTGATGCGATGGGGTC
AAAGCCAGTGTAGCGTGGC -> AAGCCAGTGTAGCGTGGCT
TTAAGTGTGTGTCCCCGCG -> TAAGTGTGTGTCCCCGCGA
ATCGGTTACATCTCGGGAT -> TCGGTTACATCTCGGGATA
GTCCTTATTATCCTGCTGT -> TCCTTATTATCCTGCTGTT
GGAAGAAGCTGGGCTGCTT -> GAAGAAGCTGGGCTGCTTC
GGCATGAGGGTGTGCCGCG -> GCATGAGGGTGTGCCGCGA
ATACGTATTATCATCGCGG -> TACGTATTATCATCGCGGT
TCCCTTAGACAGTTTCAGT -> CCCTTAGACAGTTTCAGTC
ATGCCCTATCGACGTTGCT -> TGCCCTATCGACGTTGCTT
ATAAGTTTCCTCTTTGATT -> TAAGTTTCCTCTTTGATTA
GAACACACCGGCGTTGACT -> AACACACCGGCGTTGACTA
GATTATTTTATTCTAGGCA -> ATTATTTTATTCTAGGCAT
AGACAGTGAGTGCCACCTT -> GACAGTGAGTGCCACCTTT
TTCGCATCCTCGGTTGAAA -> TCGCATCCTCGGTTGAAAC
ACTAAAGCGTCGAGCGGGC -> CTAAAGCGTCGAGCGGGCT
GTCTGGTGGCCGGTAAAAA -> TCTGGTGGCCGGTAAAAAC
TGAGTTCATCACACTGGCT -> GAGTTCATCACACTGGCTG
TGTATAGGCTCCCTTAGAC -> GTATAGGCTCCCTTAGACA
AGAAGCTGGGCTGCTTCGT -> GAAGCTGGGCTGCTTCGTC
GTATCTATTGGTACGCCGA -> TATCTATTGGTACGCCGAC
GCCAGTAGTCTACCTAGCG -> CCAGTAGTCTACCTAGCGA
ATCTTCACTCGCCCTGTGG -> TCTTCACTCGCCCTGTGGA
GCTATGAGAATACTCTGAG -> CTATGAGAATACTCTGAGA
TCGGTTGAAACGAATGGAG -> CGGTTGAAACGAATGGAGA
GGTATCTATTGGTACGCCG -> GTATCTATTGGTACGCCGA
AGCCATCGACAGTGCTGCA -> GCCATCGACAGTGCTGCAG
GGTAAGAAGCTCTCCCTAC -> GTAAGAAGCTCTCCCTACT
TGCTTCTGTACGGGTCTGG -> GCTTCTGTACGGGTCTGGT
TGGCTGGGGAAAGCCAGTG -> GGCTGGGGAAAGCCAGTGT
TCGCATTCTTAGGACGGGT -> CGCATTCTTAGGACGGGTG
CCAGTGTAGCGTGGCTTAC -> CAGTGTAGCGTGGCTTACT
TCGAGTTGCCGGCTGATAA -> CGAGTTGCCGGCTGATAAG
AACGCAAATATCCGTCCTT -> ACGCAAATATCCGTCCTTA
GAAACAAGCTGCCAAAGCC -> AAACAAGCTGCCAAAGCCC
CGCATTCTTAGGACGGGTG -> GCATTCTTAGGACGGGTGC
GTGAGGGCATGAGGGTGTG -> TGAGGGCATGAGGGTGTGC
TACTAAATTACCCAGAAGT -> ACTAAATTACCCAGAAGTC
ACCTAGCGACTACCCGGTT -> CCTAGCGACTACCCGGTTA
CCACCTTTCGGGTAATGCC -> CACCTTTCGGGTAATGCCA
TGACTACGACCTAGTCGTC -> GACTACGACCTAGTCGTCC
GACGTTGCTTCCCTCCGCT -> ACGTTGCTTCCCTCCGCTC
CGCGAGACAGTGAGTGCCA -> GCGAGACAGTGAGTGCCAC
GACGGAATCCTACAATCCC -> ACGGAATCCTACAATCCCA
TGGGACGTCCTTATTATCC -> GGGACGTCCTTATTATCCT
TGCGCATGACCCAATCATG -> GCGCATGACCCAATCATGA
CAGTGTAGCGTGGCTTACT -> AGTGTAGCGTGGCTTACTG
GTTACGTGTCGTGTACGAG -> TTACGTGTCGTGTACGAGA
TATTCAAAATGAAGAGGTT -> ATTCAAAATGAAGAGGTTT
ATCGACGTTGTTGGTGGTA -> TCGACGTTGTTGGTGGTAT
CTTTGATTAAACTTAGTTA -> TTTGATTAAACTTAGTTAG
AACATGGCAATTGGCCCTG -> ACATGGCAATTGGCCCTGC
CGCCGCGATATACAAGGAT -> GCCGCGATATACAAGGATA
CGACTAAAGCGTCGAGCGG -> GACTAAAGCGTCGAGCGGG
TGCCCTATCGACGTTGCTT -> GCCCTATCGACGTTGCTTC
GTGTTACGGTCATAACATG -> TGTTACGGTCATAACATGG
CTCCATTACGCCAAGAGAC -> TCCATTACGCCAAGAGACT
TTGAACGGGATGAAGGTCG -> TGAACGGGATGAAGGTCGG
CTGCGATCCATGCTCGTCA -> TGCGATCCATGCTCGTCAA
ACGTCCCATAAATATTGTC -> CGTCCCATAAATATTGTCA
ACACACCGGCGTTGACTAC -> CACACCGGCGTTGACTACG
TCGACGTTGCTTCCCTCCG -> CGACGTTGCTTCCCTCCGC
GCGCCTTGTAGGGTCGCCG -> CGCCTTGTAGGGTCGCCGG
GGGGTGGCAATTGCTTCTG -> GGGTGGCAATTGCTTCTGT
CATGACCCAATCATGAGTG -> ATGACCCAATCATGAGTGA
ACTACCCGGTTATGTTGTC -> CTACCCGGTTATGTTGTCA
GACTCGAGTTGCCGGCTGA -> ACTCGAGTTGCCGGCTGAT
TTCATCACACTGGCTGGGG -> TCATCACACTGGCTGGGGA
TGTTTATAAGCTGTAGCGT -> GTTTATAAGCTGTAGCGTC
TAGTCTATGTTAGATTGAT -> AGTCTATGTTAGATTGATA
TCGACAGTGCTGCAGCAGA -> CGACAGTGCTGCAGCAGAG
AGTGCTTGCTACTGAAATG -> GTGCTTGCTACTGAAATGT
TTGTGTACATTATCGATTC -> TGTGTACATTATCGATTCG
CTTAGGACGGGTGCCTTCT -> TTAGGACGGGTGCCTTCTA
TCTCGGGATACCTGCGCCG -> CTCGGGATACCTGCGCCGC
TATTCTGAAGCATGTATAG -> ATTCTGAAGCATGTATAGG
GATTCTTATGCCCTATCGA -> ATTCTTATGCCCTATCGAC
GATACCTGCGCCGCGATAT -> ATACCTGCGCCGCGATATA
GTGCGTAACCCCCCCTGCA -> TGCGTAACCCCCCCTGCAG
TTGATTACCGAGTAAGTCA -> TGATTACCGAGTAAGTCAG
GCGGCGGGGGTATCTATTG -> CGGCGGGGGTATCTATTGG
GTTGAACGGGATGAAGGTC -> TTGAACGGGATGAAGGTCG
TATCCTGCTACTGTCGTTG -> ATCCTGCTACTGTCGTTGT
TCGCCGGGCTTGATTACCG -> CGCCGGGCTTGATTACCGA
AGCCTGTCCCCTAACGCAA -> GCCTGTCCCCTAACGCAAA
GGGTCGCCGGGCTTGATTA -> GGTCGCCGGGCTTGATTAC
CACTGAGATATACTGAGGG -> ACTGAGATATACTGAGGGA
AGAGGCGCTCCCCATATCG -> GAGGCGCTCCCCATATCGC
CCGACGTGGGCTAGTGCGT -> CGACGTGGGCTAGTGCGTG
CTCATAGGTGGCGTGCGCA -> TCATAGGTGGCGTGCGCAT
GCGAGACAGTGAGTGCCAC -> CGAGACAGTGAGTGCCACC
ACGCAAATATCCGTCCTTA -> CGCAAATATCCGTCCTTAT
ATCTATTGGTACGCCGACG -> TCTATTGGTACGCCGACGT
CTATTTGAGTTCATCACAC -> TATTTGAGTTCATCACACT
AAGCTAAGATTAGAACCTC -> AGCTAAGATTAGAACCTCG
CTGATTGCGCATACGTATT -> TGATTGCGCATACGTATTA
GTACGTACGTAATGCCTCC -> TACGTACGTAATGCCTCCA
CCATGTGAGGGCATGAGGG -> CATGTGAGGGCATGAGGGT
ACCTGGGACGTCCTTATTA -> CCTGGGACGTCCTTATTAT
TGGAGTACATTATCGATTC -> GGAGTACATTATCGATTCG
TGACGGCCGACCACTGGGT -> GACGGCCGACCACTGGGTC
CACTGGCTGGGGAAAGCCA -> ACTGGCTGGGGAAAGCCAG
CCTGGGACGTCCTTATTAT -> CTGGGACGTCCTTATTATC
TCTTAGGACGGGTGCCTTC -> CTTAGGACGGGTGCCTTCT
GTGTCCGCCGACTTAGGTT -> TGTCCGCCGACTTAGGTTG
CTACCCGGTTATGTTGTCA -> TACCCGGTTATGTTGTCAC
CCCCGCGACCAAACCCCCT -> CCCGCGACCAAACCCCCTG
AAGGTCGGTTATGCCACTG -> AGGTCGGTTATGCCACTGG
TGGGGTGGCAATTGCTTCT -> GGGGTGGCAATTGCTTCTG
CCGTCAATCTTCTTCGTCA -> CGTCAATCTTCTTCGTCAG
CCTTTCGGGTAATGCCAAG -> CTTTCGGGTAATGCCAAGC
GTAGCGTCCTTATTATCCT -> TAGCGTCCTTATTATCCTG
ATCATGAGTGAACATATGG -> TCATGAGTGAACATATGGA
CTGCTTGATGCGACGTGTA -> TGCTTGATGCGACGTGTAC
ATTACCGAGTAAGTCAGTA -> TTACCGAGTAAGTCAGTAT
CCTGGCAAACAACCGGAGT -> CTGGCAAACAACCGGAGTG
AGCCCAACCGTCAATCTTC -> GCCCAACCGTCAATCTTCT
ATCGATTCGCATCCTCGGT -> TCGATTCGCATCCTCGGTT
GGGGCACAGCTGACTCGAG -> GGGCACAGCTGACTCGAGT
ATTATGCTCGACCACCGCG -> TTATGCTCGACCACCGCGG
GACAGTGCTGCAGCAGAGG -> ACAGTGCTGCAGCAGAGGC
TATTCGGGGCTAACCATGT -> ATTCGGGGCTAACCATGTG
TAGTCTACCTAGCGACTAC -> AGTCTACCTAGCGACTACC
CCTTATTATCCTGCTACTG -> CTTATTATCCTGCTACTGT
ATTCTGATCAATGGAGCGC -> TTCTGATCAATGGAGCGCA
TAAATTACCCAGAAGTCAA -> AAATTACCCAGAAGTCAAA
GCCGACTTAGGTTGGTATT -> CCGACTTAGGTTGGTATTC
CACGAGCTAGTGATCGACG -> ACGAGCTAGTGATCGACGT
TGCTACTGAAATGTCAGTC -> GCTACTGAAATGTCAGTCG
CTACCTAGCGACTACCCGG -> TACCTAGCGACTACCCGGT
CAAACCCCCTGGCAAACAA -> AAACCCCCTGGCAAACAAC
GTCGTTGTGTACATTATCG -> TCGTTGTGTACATTATCGA
AGGGCATGAGGGTGTGCCG -> GGGCATGAGGGTGTGCCGC
CGTATTATCATCGCGGTAT -> GTATTATCATCGCGGTATT
AGCTGCCAAAGCCCAACCG -> GCTGCCAAAGCCCAACCGT
AAATATCCGTCCTTATTAT -> AATATCCGTCCTTATTATC
GCCACCAGCCCTCTGACGA -> CCACCAGCCCTCTGACGAC
ATTCGCATCCTCGGTTGAA -> TTCGCATCCTCGGTTGAAA
GGACCTGCCCGGCCACGAC -> GACCTGCCCGGCCACGACC
CAAAGCCCAACCGTCAATC -> AAAGCCCAACCGTCAATCT
TACAAGGATAGCTCGGAGC -> ACAAGGATAGCTCGGAGCT
AGTCTATGTTAGATTGATA -> GTCTATGTTAGATTGATAT
TGGAAGAAGCTGGGCTGCT -> GGAAGAAGCTGGGCTGCTT
CAATCGTCGTGCCAACCTC -> AATCGTCGTGCCAACCTCC
GTATTCAAAATGAAGAGGT -> TATTCAAAATGAAGAGGTT
CTCTTACGTAATAGATCAC -> TCTTACGTAATAGATCACG
AGACTGGGGGTCCTCGTAG -> GACTGGGGGTCCTCGTAGC
GGTGCCTTCTATTTGAGTT -> GTGCCTTCTATTTGAGTTC
TGCGTAACCCCCCCTGCAG -> GCGTAACCCCCCCTGCAGG
GTACATAGTCTATGTTAGA -> TACATAGTCTATGTTAGAT
TGTCCGCCGACTTAGGTTG -> GTCCGCCGACTTAGGTTGG
AAGAAGCTGGGCTGCTTCG -> AGAAGCTGGGCTGCTTCGT
GTGTACGTACGTAATGCCT -> TGTACGTACGTAATGCCTC
GCCTTCTATTTGAGTTCAT -> CCTTCTATTTGAGTTCATC
CGTCCTTATTATCCTGCTC -> GTCCTTATTATCCTGCTCA
CCCTGTGGAGAGACTCTGG -> CCTGTGGAGAGACTCTGGT
GAGACAGTGAGTGCCACCT -> AGACAGTGAGTGCCACCTT
CGTGCGTAACCCCCCCTGC -> GTGCGTAACCCCCCCTGCA
AGCCCTCTGACGACAACGT -> GCCCTCTGACGACAACGTA
CGATTCTTATGCCCTATCG -> GATTCTTATGCCCTATCGA
AGAGGTCTGCTATGAGAAT -> GAGGTCTGCTATGAGAATA
TGTCCCCGCGACCAAACCC -> GTCCCCGCGACCAAACCCC
GAGGGTGTGCCGCGACTAA -> AGGGTGTGCCGCGACTAAA
GGCTCATGCTTTCACGTCC -> GCTCATGCTTTCACGTCCC
GTGGTATGTAAGAGAGCTA -> TGGTATGTAAGAGAGCTAG
CATAGTCTATGTTAGATTG -> ATAGTCTATGTTAGATTGA
TTACGCCAAGAGACTATCT -> TACGCCAAGAGACTATCTT
TCCTTATTATCCTGCTGTT -> CCTTATTATCCTGCTGTTA
TATAAGCTGTAGCGTCCTT -> ATAAGCTGTAGCGTCCTTA
CTTACGTAATAGATCACGC -> TTACGTAATAGATCACGCG
CTTAGTTAGGTGGGGTGGC -> TTAGTTAGGTGGGGTGGCA
TGAACATATGGACGGAAAC -> GAACATATGGACGGAAACA
TCGATTCGCATTCCTGATT -> CGATTCGCATTCCTGATTG
GTATTTTGTGTTTATAAGC -> TATTTTGTGTTTATAAGCT
GGTGGGGTGGCAATTGCTT -> GTGGGGTGGCAATTGCTTC
CCTGGATACTAAATTACCC -> CTGGATACTAAATTACCCA
AACCTGGGACGTCCTTATT -> ACCTGGGACGTCCTTATTA
TCGTAACGTACCACTGAGA -> CGTAACGTACCACTGAGAT
GATTAGAACCTCGCACCAA -> ATTAGAACCTCGCACCAAG
GTCTTAGGCATTCGCCACC -> TCTTAGGCATTCGCCACCA
CGGGCTCATGCTTTCACGT -> GGGCTCATGCTTTCACGTC
CCAACCGTCAATCTTCTTC -> CAACCGTCAATCTTCTTCG
GAAATGTCAGTCGGTCTTA -> AAATGTCAGTCGGTCTTAG
GTTCAAGTATTCGGGGCTA -> TTCAAGTATTCGGGGCTAA
TGTTACGGTCATAACATGG -> GTTACGGTCATAACATGGC
GGTCATAACATGGCAATTG -> GTCATAACATGGCAATTGG
TCGTTGTGTACATTATCGA -> CGTTGTGTACATTATCGAT
CGTGGGCTAGTGCGTGGTA -> GTGGGCTAGTGCGTGGTAC
ACGGGTGCCTTCTATTTGA -> CGGGTGCCTTCTATTTGAG
TTATTTTATTCTAGGCATT -> TATTTTATTCTAGGCATTA
ATCAATGGAGCGCAGCTCA -> TCAATGGAGCGCAGCTCAT
CATAAATATTGTCATAGGT -> ATAAATATTGTCATAGGTG
TCTCCCTACTTAACCTGGG -> CTCCCTACTTAACCTGGGA
ATTAGATTCGTGCGTAACC -> TTAGATTCGTGCGTAACCC
CAGCCCTCTGACGACAACG -> AGCCCTCTGACGACAACGT
TCCTACAATCCCATGGTAA -> CCTACAATCCCATGGTAAT
CTGGATACTAAATTACCCA -> TGGATACTAAATTACCCAG
ATTCGCATTCCTGATTGCG -> TTCGCATTCCTGATTGCGC
ATGGACGGAAACAAGCTGC -> TGGACGGAAACAAGCTGCC
ACGGGTCTGGTGGCCGGTA -> CGGGTCTGGTGGCCGGTAA
AGCTCGGAGCTCTTACGTA -> GCTCGGAGCTCTTACGTAA
CAACAGAAGGGGGACCTGC -> AACAGAAGGGGGACCTGCC
CGGCTGATAAGTTTCCTCT -> GGCTGATAAGTTTCCTCTT
TGTGGAGTGCTTGCTACTG -> GTGGAGTGCTTGCTACTGA
GTAAGTCAGTATGGTTATG -> TAAGTCAGTATGGTTATGT
ATTTGAGTTCATCACACTG -> TTTGAGTTCATCACACTGG
AGTATGGTTATGTCCATCG -> GTATGGTTATGTCCATCGT
CCAAAGCCCAACCGTCAAT -> CAAAGCCCAACCGTCAATC
ATTCGCCACCAGCCCTCTG -> TTCGCCACCAGCCCTCTGA
ATTCGCATTCTTAGGACGG -> TTCGCATTCTTAGGACGGG
TTGAAACGAATGGAGAGGC -> TGAAACGAATGGAGAGGCG
TCGTCACGAACGATTTAAA -> CGTCACGAACGATTTAAAA
AGGTGTGTACGTACGTAAT -> GGTGTGTACGTACGTAATG
CGACGTGGGCTAGTGCGTG -> GACGTGGGCTAGTGCGTGG
TTCACTCGCCCTGTGGAGA -> TCACTCGCCCTGTGGAGAG
TCTTCTTCGTCAGTCCCGT -> CTTCTTCGTCAGTCCCGTA
TTACTCCCGGGTACATTAT -> TACTCCCGGGTACATTATC
ATGAAGAGGTTTTTGTAAA -> TGAAGAGGTTTTTGTAAAG
TTTCGGGTAATGCCAAGCG -> TTCGGGTAATGCCAAGCGT
AGTGTATGACGGCCGACCA -> GTGTATGACGGCCGACCAC
TATCGATTCGCATTCCTGA -> ATCGATTCGCATTCCTGAT
GGCTGTGCTCCCTCGCCCT -> GCTGTGCTCCCTCGCCCTC
CTACGACCTAGTCGTCCTT -> TACGACCTAGTCGTCCTTA
ATTTATCTCTACCCACCGC -> TTTATCTCTACCCACCGCT
CGGGGCTAACCATGTGAGG -> GGGGCTAACCATGTGAGGG
CGTCCGAACACACCGGCGT -> GTCCGAACACACCGGCGTT
TACGAGAGGTCTGCTATGA -> ACGAGAGGTCTGCTATGAG
TGTGTGTCCCCGCGACCAA -> GTGTGTCCCCGCGACCAAA
GCTAACCATGTGAGGGCAT -> CTAACCATGTGAGGGCATG
CTTAACCTGGGACGTCCTT -> TTAACCTGGGACGTCCTTA
CATGCTCGTCAAGTTGGGG -> ATGCTCGTCAAGTTGGGGC
CTGGCTGGGGAAAGCCAGT -> TGGCTGGGGAAAGCCAGTG
TACCCACCGCTGCATCGTG -> ACCCACCGCTGCATCGTGT
AAAGAACCCAGGTGTTACC -> AAGAACCCAGGTGTTACCA
TCAGGCTGTGCTCCCTCGC -> CAGGCTGTGCTCCCTCGCC
GTCATAACATGGCAATTGG -> TCATAACATGGCAATTGGC
GGCGCTCCCCATATCGCCA -> GCGCTCCCCATATCGCCAT
AGGGTGTGCCGCGACTAAA -> GGGTGTGCCGCGACTAAAG
CGACCGCGTAAACACGAGC -> GACCGCGTAAACACGAGCT
GCATTCGCCACCAGCCCTC -> CATTCGCCACCAGCCCTCT
CGCTCCCCATATCGCCATC -> GCTCCCCATATCGCCATCA
TGTTTTTCCATTAGATTCG -> GTTTTTCCATTAGATTCGT
GTCGTGCCAACCTCCCTGT -> TCGTGCCAACCTCCCTGTT
CCCGGGTACATTATCGATT -> CCGGGTACATTATCGATTC
CAGCTCATAGGTGGCGTGC -> AGCTCATAGGTGGCGTGCG
CATCGTAACGTACCACTGA -> ATCGTAACGTACCACTGAG
TTTAGTGGACCATCATATT -> TTAGTGGACCATCATATTA
GGGGTCCTCGTAGCCATCG -> GGGTCCTCGTAGCCATCGA
GGTACATAGTCTATGTTAG -> GTACATAGTCTATGTTAGA
AGAATACTCTGAGAGATTC -> GAATACTCTGAGAGATTCT
CATACGTATTATCATCGCG -> ATACGTATTATCATCGCGG
TTCGTCACGAACGATTTAA -> TCGTCACGAACGATTTAAA
ACCCGGGTAAGAAGCTCTC -> CCCGGGTAAGAAGCTCTCC
GAAGCTGGGCTGCTTCGTC -> AAGCTGGGCTGCTTCGTCA
GCGATTCTTATGCCCTATC -> CGATTCTTATGCCCTATCG
TAGCTCGGAGCTCTTACGT -> AGCTCGGAGCTCTTACGTA
TTGCGCATACGTATTATCA -> TGCGCATACGTATTATCAT
ACATAGTCTATGTTAGATT -> CATAGTCTATGTTAGATTG
TACGTAATGCCTCCAGTGC -> ACGTAATGCCTCCAGTGCG
GCAGCTCATAGGTGGCGTG -> CAGCTCATAGGTGGCGTGC
AGTTTCCTCTTTGATTAAA -> GTTTCCTCTTTGATTAAAC
CGACGTTGTTGGTGGTATG -> GACGTTGTTGGTGGTATGT
CGACCACTGGGTCATTCCG -> GACCACTGGGTCATTCCGC
TGATCGACGTTGTTGGTGG -> GATCGACGTTGTTGGTGGT
ATCGCCATCAGAAGATATC -> TCGCCATCAGAAGATATCG
ACCTGCGCCGCGATATACA -> CCTGCGCCGCGATATACAA
GTTGCCGGCTGATAAGTTT -> TTGCCGGCTGATAAGTTTC
GCCCTATCGACGTTGCTTC -> CCCTATCGACGTTGCTTCC
TCCTGCTGTTACTCCCGGG -> CCTGCTGTTACTCCCGGGT
CCCACCGCTGCATCGTGTC -> CCACCGCTGCATCGTGTCC
AGAAGATATCGGTTACATC -> GAAGATATCGGTTACATCT
AGTGTAGCGTGGCTTACTG -> GTGTAGCGTGGCTTACTGC
ATGGGGTCCTAGCGTTGGA -> TGGGGTCCTAGCGTTGGAA
CACACTGGCTGGGGAAAGC -> ACACTGGCTGGGGAAAGCC
CCACAATCACTCCATTACG -> CACAATCACTCCATTACGC
TCTAGGCATTATGCTCGAC -> CTAGGCATTATGCTCGACC
AAGCCCGTTAGGTTTTAGT -> AGCCCGTTAGGTTTTAGTG
TCTTCACTCGCCCTGTGGA -> CTTCACTCGCCCTGTGGAG
AGTTCATCACACTGGCTGG -> GTTCATCACACTGGCTGGG
TATGAGAATACTCTGAGAG -> ATGAGAATACTCTGAGAGA
GCCAGTGTAGCGTGGCTTA -> CCAGTGTAGCGTGGCTTAC
CTAGCGTTGGAAGAAGCTG -> TAGCGTTGGAAGAAGCTGG
CCATTAGATTCGTGCGTAA -> CATTAGATTCGTGCGTAAC
CGGTTATGTTGTCACCACA -> GGTTATGTTGTCACCACAT
AACCGTCAATCTTCTTCGT -> ACCGTCAATCTTCTTCGTC
ACGAATGGAGAGGCGCTCC -> CGAATGGAGAGGCGCTCCC
AAGCATGTATAGGCTCCCT -> AGCATGTATAGGCTCCCTT
CACAACAGGCCTGTGGAGT -> ACAACAGGCCTGTGGAGTG
ACTTAACCTGGGACGTCCT -> CTTAACCTGGGACGTCCTT
TAATGCCTCCAGTGCGATT -> AATGCCTCCAGTGCGATTC
CCCAGGTGTTACCACAGAA -> CCAGGTGTTACCACAGAAG
ATGCCTCCAGTGCGATTCT -> TGCCTCCAGTGCGATTCTT
TCAGTGTATGACGGCCGAC -> CAGTGTATGACGGCCGACC
TGCGACGTGTACATTATCG -> GCGACGTGTACATTATCGA
TCGTGCGTAACCCCCCCTG -> CGTGCGTAACCCCCCCTGC
CTCGTACTTTGATGCGATG -> TCGTACTTTGATGCGATGG
CCGCGACCAAACCCCCTGG -> CGCGACCAAACCCCCTGGC
GTATTCTGAAGCATGTATA -> TATTCTGAAGCATGTATAG
AGGGTCGCCGGGCTTGATT -> GGGTCGCCGGGCTTGATTA
TGGCAATTGCTTCTGTACG -> GGCAATTGCTTCTGTACGG
GGAGTGGGCAGGTGGACGG -> GAGTGGGCAGGTGGACGGA
GGGCACAGCTGACTCGAGT -> GGCACAGCTGACTCGAGTT
ACAATCACTCCATTACGCC -> CAATCACTCCATTACGCCA
GGATTATTTTATTCTAGGC -> GATTATTTTATTCTAGGCA
ATTATCATCGCGGTATTCA -> TTATCATCGCGGTATTCAA
TCCCATGGTAATTCTGATC -> CCCATGGTAATTCTGATCA
GATTCTATTGAAAATACCT -> ATTCTATTGAAAATACCTA
CCGAACACACCGGCGTTGA -> CGAACACACCGGCGTTGAC
ATAGTCGTGGCCAGTAGTC -> TAGTCGTGGCCAGTAGTCT
GGTCCTAGCGTTGGAAGAA -> GTCCTAGCGTTGGAAGAAG
TTCCTCTTTGATTAAACTT -> TCCTCTTTGATTAAACTTA
GCGTGCGCATGACCCAATC -> CGTGCGCATGACCCAATCA
GGTAATTCTGATCAATGGA -> GTAATTCTGATCAATGGAG
ACACGAGCTAGTGATCGAC -> CACGAGCTAGTGATCGACG
TTGTCACCACATGCATCCA -> TGTCACCACATGCATCCAC
TGCCAACCTCCCTGTTGAA -> GCCAACCTCCCTGTTGAAC
TGGCTTACTGCGCCTTGTA -> GGCTTACTGCGCCTTGTAG
GACAGTGAGTGCCACCTTT -> ACAGTGAGTGCCACCTTTC
GCGTTGACTACGACCTAGT -> CGTTGACTACGACCTAGTC
TCAGTCGTCCGAACACACC -> CAGTCGTCCGAACACACCG
AGTGCGATTCTTATGCCCT -> GTGCGATTCTTATGCCCTA
TACGTAATAGATCACGCGA -> ACGTAATAGATCACGCGAG
GATACTAAATTACCCAGAA -> ATACTAAATTACCCAGAAG
ACATTATCGATTCGCATCC -> CATTATCGATTCGCATCCT
GGGTCATTCCGCGTTTTTA -> GGTCATTCCGCGTTTTTAA
CATGAGGGTGTGCCGCGAC -> ATGAGGGTGTGCCGCGACT
TATAGGCTCCCTTAGACAG -> ATAGGCTCCCTTAGACAGT
ATATACAAGGATAGCTCGG -> TATACAAGGATAGCTCGGA
GGTAAAAACAGCGTCCTGG -> GTAAAAACAGCGTCCTGGA
ATGCCACTGGCGACCTCGT -> TGCCACTGGCGACCTCGTA
TGCTCAGCACCTGGAGTAC -> GCTCAGCACCTGGAGTACA
TATGGACGGAAACAAGCTG -> ATGGACGGAAACAAGCTGC
TCAGCACCTGGAGTACATT -> CAGCACCTGGAGTACATTA
AATCATGAGTGAACATATG -> ATCATGAGTGAACATATGG
AGCGACTACCCGGTTATGT -> GCGACTACCCGGTTATGTT
AGGACGGGTGCCTTCTATT -> GGACGGGTGCCTTCTATTT
GTCAAACCCGGGTAAGAAG -> TCAAACCCGGGTAAGAAGC
ATGTAAGAGAGCTAGATTC -> TGTAAGAGAGCTAGATTCA
CTAGCGACTACCCGGTTAT -> TAGCGACTACCCGGTTATG
TGATAAGTTTCCTCTTTGA -> GATAAGTTTCCTCTTTGAT
AGATTAGAACCTCGCACCA -> GATTAGAACCTCGCACCAA
CGTCGAGCGGGCTCATGCT -> GTCGAGCGGGCTCATGCTT
GCCCGGCCACGACCGCGTA -> CCCGGCCACGACCGCGTAA
TCAGAAGATATCGGTTACA -> CAGAAGATATCGGTTACAT
GTAGGGTCGCCGGGCTTGA -> TAGGGTCGCCGGGCTTGAT
TGTTGGTGGTATGTAAGAG -> GTTGGTGGTATGTAAGAGA
TATTAAAGTTACACAACAG -> ATTAAAGTTACACAACAGG
TGCTACTGTCGTTGTGTAC -> GCTACTGTCGTTGTGTACA
GTTACATCTCGGGATACCT -> TTACATCTCGGGATACCTG
GGCTAGTGCGTGGTACATA -> GCTAGTGCGTGGTACATAG
AATTCTGATCAATGGAGCG -> ATTCTGATCAATGGAGCGC
ACCTCGCACCAAGACTGGG -> CCTCGCACCAAGACTGGGG
TCGACCACCGCGGCGGGGG -> CGACCACCGCGGCGGGGGT
CTGATCAATGGAGCGCAGC -> TGATCAATGGAGCGCAGCT
CCTGCTGTTACTCCCGGGT -> CTGCTGTTACTCCCGGGTA
CTCGTCAAGTTGGGGCACA -> TCGTCAAGTTGGGGCACAG
AACAACCGGAGTGGGCAGG -> ACAACCGGAGTGGGCAGGT
AAGAACCCAGGTGTTACCA -> AGAACCCAGGTGTTACCAC
TGTATGACGGCCGACCACT -> GTATGACGGCCGACCACTG
GTAAGAAGCTCTCCCTACT -> TAAGAAGCTCTCCCTACTT
CTCGTAGCCATCGACAGTG -> TCGTAGCCATCGACAGTGC
AAGCTCTCCCTACTTAACC -> AGCTCTCCCTACTTAACCT
TGGCCAGTAGTCTACCTAG -> GGCCAGTAGTCTACCTAGC
TCAAGTATTCGGGGCTAAC -> CAAGTATTCGGGGCTAACC
GGTCTTAGGCATTCGCCAC -> GTCTTAGGCATTCGCCACC
ACCCCCCCTGCAGGATTAT -> CCCCCCCTGCAGGATTATT
TATGGTTATGTCCATCGTA -> ATGGTTATGTCCATCGTAA
GGGGGACCTGCCCGGCCAC -> GGGGACCTGCCCGGCCACG
TAGGTGGGGTGGCAATTGC -> AGGTGGGGTGGCAATTGCT
ATGGCAATTGGCCCTGCGT -> TGGCAATTGGCCCTGCGTT
TACTTAACCTGGGACGTCC -> ACTTAACCTGGGACGTCCT
GTCGTGGCCAGTAGTCTAC -> TCGTGGCCAGTAGTCTACC
ATTCTGAAGCATGTATAGG -> TTCTGAAGCATGTATAGGC
GCCAACCTCCCTGTTGAAC -> CCAACCTCCCTGTTGAACG
ATTGATATTTATCTCTACC -> TTGATATTTATCTCTACCC
CATTCTTAGGACGGGTGCC -> ATTCTTAGGACGGGTGCCT
ACCTGGAGTACATTATCGA -> CCTGGAGTACATTATCGAT
TATCGCCATCAGAAGATAT -> ATCGCCATCAGAAGATATC
CGGAGCTCTTACGTAATAG -> GGAGCTCTTACGTAATAGA
TCACGTCCCATAAATATTG -> CACGTCCCATAAATATTGT
CGTCAGTCCCGTAAGAACC -> GTCAGTCCCGTAAGAACCC
ATACTGAGGGACAACAGAA -> TACTGAGGGACAACAGAAG
GACCTGCCCGGCCACGACC -> ACCTGCCCGGCCACGACCG
TTACCCAGAAGTCAAACCC -> TACCCAGAAGTCAAACCCG
CCAGCCCTCTGACGACAAC -> CAGCCCTCTGACGACAACG
ATGACGGCCGACCACTGGG -> TGACGGCCGACCACTGGGT
TGTGCCGCGACTAAAGCGT -> GTGCCGCGACTAAAGCGTC
GTATAGGCTCCCTTAGACA -> TATAGGCTCCCTTAGACAG
GTATGTAAGAGAGCTAGAT -> TATGTAAGAGAGCTAGATT
CCTGTGGAGTGCTTGCTAC -> CTGTGGAGTGCTTGCTACT
GGTTATGCCACTGGCGACC -> GTTATGCCACTGGCGACCT
CTTAGACAGTTTCAGTCGT -> TTAGACAGTTTCAGTCGTC
CCGGGTACATTATCGATTC -> CGGGTACATTATCGATTCG
TGCCGGCTGATAAGTTTCC -> GCCGGCTGATAAGTTTCCT
AATCGTCGTGCCAACCTCC -> ATCGTCGTGCCAACCTCCC
GGTTTTTGTAAAGCCCGTT -> GTTTTTGTAAAGCCCGTTA
AGGATAGCTCGGAGCTCTT -> GGATAGCTCGGAGCTCTTA
CGCTGCATCGTGTCCGCCG -> GCTGCATCGTGTCCGCCGA
GCGCAGCTCATAGGTGGCG -> CGCAGCTCATAGGTGGCGT
TGCTGTTACTCCCGGGTAC -> GCTGTTACTCCCGGGTACA
TGATATTTATCTCTACCCA -> GATATTTATCTCTACCCAC
GGAAAGCCAGTGTAGCGTG -> GAAAGCCAGTGTAGCGTGG
ATATGGACGGAAACAAGCT -> TATGGACGGAAACAAGCTG
TCGCGGTATTCAAAATGAA -> CGCGGTATTCAAAATGAAG
CTTATTATCCTGCTGTTAC -> TTATTATCCTGCTGTTACT
CCCCCCTGCAGGATTATTT -> CCCCCTGCAGGATTATTTT
CTGGTGGCCGGTAAAAACA -> TGGTGGCCGGTAAAAACAG
GAGCTAGTGATCGACGTTG -> AGCTAGTGATCGACGTTGT
CCTCGTAGCCATCGACAGT -> CTCGTAGCCATCGACAGTG
GCTCGTCAAGTTGGGGCAC -> CTCGTCAAGTTGGGGCACA
AAGCGTTACCTTCCAGCCT -> AGCGTTACCTTCCAGCCTG
CGATCCATGCTCGTCAAGT -> GATCCATGCTCGTCAAGTT
ATTGTCATAGGTGTGTACG -> TTGTCATAGGTGTGTACGT
GCGTCGAGCGGGCTCATGC -> CGTCGAGCGGGCTCATGCT
ATTATCCTGCTACTGTCGT -> TTATCCTGCTACTGTCGTT
TACCACTGAGATATACTGA -> ACCACTGAGATATACTGAG
AGCTAGTGATCGACGTTGT -> GCTAGTGATCGACGTTGTT
GAACCCCGGAGGTTCAAGT -> AACCCCGGAGGTTCAAGTA
AATACTCTGAGAGATTCTA -> ATACTCTGAGAGATTCTAT
GGCAGGCAAAGGAGCGTGT -> GCAGGCAAAGGAGCGTGTT
CTTCTATTTGAGTTCATCA -> TTCTATTTGAGTTCATCAC
TGCGTGGTACATAGTCTAT -> GCGTGGTACATAGTCTATG
TCGCCACCAGCCCTCTGAC -> CGCCACCAGCCCTCTGACG
GGGCTGCTTCGTCACGAAC -> GGCTGCTTCGTCACGAACG
TCCTCTTTGATTAAACTTA -> CCTCTTTGATTAAACTTAG
GCATCCACAATCGTCGTGC -> CATCCACAATCGTCGTGCC
CGCCGACGTGGGCTAGTGC -> GCCGACGTGGGCTAGTGCG
GTCCTTATTATCCTGCTTG -> TCCTTATTATCCTGCTTGA
ACTGTCGTTGTGTACATTA -> CTGTCGTTGTGTACATTAT
TGTTACCACAGAAGATGGC -> GTTACCACAGAAGATGGCA
TATTGGTACGCCGACGTGG -> ATTGGTACGCCGACGTGGG
TATGTTAGATTGATATTTA -> ATGTTAGATTGATATTTAT
TGTCGTGTACGAGAGGTCT -> GTCGTGTACGAGAGGTCTG
GTTTCAGTCGTCCGAACAC -> TTTCAGTCGTCCGAACACA
CAGTGTATGACGGCCGACC -> AGTGTATGACGGCCGACCA
CTCTTTGATTAAACTTAGT -> TCTTTGATTAAACTTAGTT
TACATCTCGGGATACCTGC -> ACATCTCGGGATACCTGCG
GGTATTCAAAATGAAGAGG -> GTATTCAAAATGAAGAGGT
GCTCGGAGCTCTTACGTAA -> CTCGGAGCTCTTACGTAAT
CGCCGGGCTTGATTACCGA -> GCCGGGCTTGATTACCGAG
GCTTGATTACCGAGTAAGT -> CTTGATTACCGAGTAAGTC
CTTACTGCGCCTTGTAGGG -> TTACTGCGCCTTGTAGGGT
TTTCAGTCGTCCGAACACA -> TTCAGTCGTCCGAACACAC
CATGCATCCACAATCGTCG -> ATGCATCCACAATCGTCGT
TTTATAAGCTGTAGCGTCC -> TTATAAGCTGTAGCGTCCT
ATTCGGGGCTAACCATGTG -> TTCGGGGCTAACCATGTGA
CGAGAGGTCTGCTATGAGA -> GAGAGGTCTGCTATGAGAA
TGACTCGAGTTGCCGGCTG -> GACTCGAGTTGCCGGCTGA
TGTGTACGTACGTAATGCC -> GTGTACGTACGTAATGCCT
AAAGCCCGTTAGGTTTTAG -> AAGCCCGTTAGGTTTTAGT
ATCGTCGTGCCAACCTCCC -> TCGTCGTGCCAACCTCCCT
TACTGAGGGACAACAGAAG -> ACTGAGGGACAACAGAAGG
GGGGGTATCTATTGGTACG -> GGGGTATCTATTGGTACGC
GTGCTCCCTCGCCCTCAGT -> TGCTCCCTCGCCCTCAGTG
GGGATGAAGGTCGGTTATG -> GGATGAAGGTCGGTTATGC
TTAGAACCTCGCACCAAGA -> TAGAACCTCGCACCAAGAC
ATCTTCTTCGTCAGTCCCG -> TCTTCTTCGTCAGTCCCGT
TGTGGAGAGACTCTGGTGC -> GTGGAGAGACTCTGGTGCT
TGACCCAATCATGAGTGAA -> GACCCAATCATGAGTGAAC
GGAGCGCAGCTCATAGGTG -> GAGCGCAGCTCATAGGTGG
AATCCCATGGTAATTCTGA -> ATCCCATGGTAATTCTGAT
CTCGAGTTGCCGGCTGATA -> TCGAGTTGCCGGCTGATAA
GGAGCTCTTACGTAATAGA -> GAGCTCTTACGTAATAGAT
GGTTGAAACGAATGGAGAG -> GTTGAAACGAATGGAGAGG
ACAGCTGACTCGAGTTGCC -> CAGCTGACTCGAGTTGCCG
GGGGCTAACCATGTGAGGG -> GGGCTAACCATGTGAGGGC
ACCGCGTAAACACGAGCTA -> CCGCGTAAACACGAGCTAG
CACCTGGAGTACATTATCG -> ACCTGGAGTACATTATCGA
CGCCATCAGAAGATATCGG -> GCCATCAGAAGATATCGGT
ACAGGCCTGTGGAGTGCTT -> CAGGCCTGTGGAGTGCTTG
CGGGATACCTGCGCCGCGA -> GGGATACCTGCGCCGCGAT
CATCGCGGTATTCAAAATG -> ATCGCGGTATTCAAAATGA
CGGGTAAGAAGCTCTCCCT -> GGGTAAGAAGCTCTCCCTA
TCCTCGTAGCCATCGACAG -> CCTCGTAGCCATCGACAGT
CATGGCAATTGGCCCTGCG -> ATGGCAATTGGCCCTGCGT
GTTAGGTGGGGTGGCAATT -> TTAGGTGGGGTGGCAATTG
GTGTTTTTCCATTAGATTC -> TGTTTTTCCATTAGATTCG
TTGGTACGCCGACGTGGGC -> TGGTACGCCGACGTGGGCT
CCAGTAGTCTACCTAGCGA -> CAGTAGTCTACCTAGCGAC
GCGTTACCTTCCAGCCTGT -> CGTTACCTTCCAGCCTGTC
TAGTGCGTGGTACATAGTC -> AGTGCGTGGTACATAGTCT
GTCCGAACACACCGGCGTT -> TCCGAACACACCGGCGTTG
TTACTGCGCCTTGTAGGGT -> TACTGCGCCTTGTAGGGTC
TGGAGTGCTTGCTACTGAA -> GGAGTGCTTGCTACTGAAA
TGTTGTCACCACATGCATC -> GTTGTCACCACATGCATCC
CGAACGATTTAAAAGAACC -> GAACGATTTAAAAGAACCC
GATTACCGAGTAAGTCAGT -> ATTACCGAGTAAGTCAGTA
ATACCTAGAACCCACAATC -> TACCTAGAACCCACAATCA
TCTATTTGAGTTCATCACA -> CTATTTGAGTTCATCACAC
GATAGCTCGGAGCTCTTAC -> ATAGCTCGGAGCTCTTACG
AACAAGCTGCCAAAGCCCA -> ACAAGCTGCCAAAGCCCAA
AAACCCCCTGGCAAACAAC -> AACCCCCTGGCAAACAACC
AGGTTTTAGTGGACCATCA -> GGTTTTAGTGGACCATCAT
ATTTTATTCTAGGCATTAT -> TTTTATTCTAGGCATTATG
ACCTTTCGGGTAATGCCAA -> CCTTTCGGGTAATGCCAAG
CTGTGCTCCCTCGCCCTCA -> TGTGCTCCCTCGCCCTCAG
GTGCCTTCTATTTGAGTTC -> TGCCTTCTATTTGAGTTCA
CCCTGGCAAACAACCGGAG -> CCTGGCAAACAACCGGAGT
GATATACTGAGGGACAACA -> ATATACTGAGGGACAACAG
CTCAGTGTATGACGGCCGA -> TCAGTGTATGACGGCCGAC
ATCCTGCTGTTACTCCCGG -> TCCTGCTGTTACTCCCGGG
ACAGTTTCAGTCGTCCGAA -> CAGTTTCAGTCGTCCGAAC
TACCTAGCGACTACCCGGT -> ACCTAGCGACTACCCGGTT
GCGCATGACCCAATCATGA -> CGCATGACCCAATCATGAG
CTGGGGGTCCTCGTAGCCA -> TGGGGGTCCTCGTAGCCAT
ATTGTGTGTTTTTCCATTA -> TTGTGTGTTTTTCCATTAG
AAAATACCTAGAACCCACA -> AAATACCTAGAACCCACAA
AAACCCGGGTAAGAAGCTC -> AACCCGGGTAAGAAGCTCT
GGCATTATGCTCGACCACC -> GCATTATGCTCGACCACCG
TCAAGTTGGGGCACAGCTG -> CAAGTTGGGGCACAGCTGA
TCGTCGTGCCAACCTCCCT -> CGTCGTGCCAACCTCCCTG
GCCGCGACTAAAGCGTCGA -> CCGCGACTAAAGCGTCGAG
TGCTTGCTACTGAAATGTC -> GCTTGCTACTGAAATGTCA
GATGCGATGGGGTCCTAGC -> ATGCGATGGGGTCCTAGCG
GCCACCTTTCGGGTAATGC -> CCACCTTTCGGGTAATGCC
ACGTACCACTGAGATATAC -> CGTACCACTGAGATATACT
TGCCACTGGCGACCTCGTA -> GCCACTGGCGACCTCGTAC
ACGGCCGACCACTGGGTCA -> CGGCCGACCACTGGGTCAT
TTGTTGGTGGTATGTAAGA -> TGTTGGTGGTATGTAAGAG
ACTTTGATGCGATGGGGTC -> CTTTGATGCGATGGGGTCC
TATTGAAAATACCTAGAAC -> ATTGAAAATACCTAGAACC
TATTTTATTCTAGGCATTA -> ATTTTATTCTAGGCATTAT
TATCCGTCCTTATTATCCT -> ATCCGTCCTTATTATCCTG
CTATGAGAATACTCTGAGA -> TATGAGAATACTCTGAGAG
TTACGTAATAGATCACGCG -> TACGTAATAGATCACGCGA
CTGTTGAACGGGATGAAGG -> TGTTGAACGGGATGAAGGT
CAATTGCTTCTGTACGGGT -> AATTGCTTCTGTACGGGTC
GTTCATCACACTGGCTGGG -> TTCATCACACTGGCTGGGG
ACTTAGGTTGGTATTCTGA -> CTTAGGTTGGTATTCTGAA
CATAGGTGTGTACGTACGT -> ATAGGTGTGTACGTACGTA
GTCCTCGTAGCCATCGACA -> TCCTCGTAGCCATCGACAG
TCGATTCGCATTCTTAGGA -> CGATTCGCATTCTTAGGAC
TGCCTTCTATTTGAGTTCA -> GCCTTCTATTTGAGTTCAT
AGGCGCTCCCCATATCGCC -> GGCGCTCCCCATATCGCCA
GCGTGGCTTACTGCGCCTT -> CGTGGCTTACTGCGCCTTG
GTTTTAGTGGACCATCATA -> TTTTAGTGGACCATCATAT
ATCATATTAAAGTTACACA -> TCATATTAAAGTTACACAA
TTCCAGCCTGTCCCCTAAC -> TCCAGCCTGTCCCCTAACG
CCAATCATGAGTGAACATA -> CAATCATGAGTGAACATAT
AAGCGTCGAGCGGGCTCAT -> AGCGTCGAGCGGGCTCATG
TAGGCTCCCTTAGACAGTT -> AGGCTCCCTTAGACAGTTT
GCTACTGAAATGTCAGTCG -> CTACTGAAATGTCAGTCGG
TGCTCGTCAAGTTGGGGCA -> GCTCGTCAAGTTGGGGCAC
AGAACCCCGGAGGTTCAAG -> GAACCCCGGAGGTTCAAGT
GAATCCTACAATCCCATGG -> AATCCTACAATCCCATGGT
GCTGCGATCCATGCTCGTC -> CTGCGATCCATGCTCGTCA
CTAAGATTAGAACCTCGCA -> TAAGATTAGAACCTCGCAC
AAGAACCCCGGAGGTTCAA -> AGAACCCCGGAGGTTCAAG
TGCGTTGACCGCGTATTTT -> GCGTTGACCGCGTATTTTG
TGCGCCGCGATATACAAGG -> GCGCCGCGATATACAAGGA
CACCGCTGCATCGTGTCCG -> ACCGCTGCATCGTGTCCGC
GTTAGATTGATATTTATCT -> TTAGATTGATATTTATCTC
AAATACCTAGAACCCACAA -> AATACCTAGAACCCACAAT
GGCAGGTGGACGGAATCCT -> GCAGGTGGACGGAATCCTA
GTGTACGAGAGGTCTGCTA -> TGTACGAGAGGTCTGCTAT
CGGGATGAAGGTCGGTTAT -> GGGATGAAGGTCGGTTATG
GACCGCGTATTTTGTGTTT -> ACCGCGTATTTTGTGTTTA
GTCGTGTACGAGAGGTCTG -> TCGTGTACGAGAGGTCTGC
GGTTGGTATTCTGAAGCAT -> GTTGGTATTCTGAAGCATG
CCTGCTACTGTCGTTGTGT -> CTGCTACTGTCGTTGTGTA
GTACGAGAGGTCTGCTATG -> TACGAGAGGTCTGCTATGA
TTGACCGCGTATTTTGTGT -> TGACCGCGTATTTTGTGTT
GTAGCCATCGACAGTGCTG -> TAGCCATCGACAGTGCTGC
TTTATTCTAGGCATTATGC -> TTATTCTAGGCATTATGCT
TCTTACGTAATAGATCACG -> CTTACGTAATAGATCACGC
ACGGTCATAACATGGCAAT -> CGGTCATAACATGGCAATT
AGAAGGGGGACCTGCCCGG -> GAAGGGGGACCTGCCCGGC
ACGACCTAGTCGTCCTTAT -> CGACCTAGTCGTCCTTATT
CGAACACACCGGCGTTGAC -> GAACACACCGGCGTTGACT
TTGCCGGCTGATAAGTTTC -> TGCCGGCTGATAAGTTTCC
TATTGTCATAGGTGTGTAC -> ATTGTCATAGGTGTGTACG
AAGCTGGGCTGCTTCGTCA -> AGCTGGGCTGCTTCGTCAC
TCCTGCTTGATGCGACGTG -> CCTGCTTGATGCGACGTGT
CTCGGAGCTCTTACGTAAT -> TCGGAGCTCTTACGTAATA
CTTGTAGGGTCGCCGGGCT -> TTGTAGGGTCGCCGGGCTT
ATTTAAAAGAACCCAGGTG -> TTTAAAAGAACCCAGGTGT
CTGCAGGATTATTTTATTC -> TGCAGGATTATTTTATTCT
GCGACTACCCGGTTATGTT -> CGACTACCCGGTTATGTTG
GATATACAAGGATAGCTCG -> ATATACAAGGATAGCTCGG
ATTAAACTTAGTTAGGTGG -> TTAAACTTAGTTAGGTGGG
CGATGGGGTCCTAGCGTTG -> GATGGGGTCCTAGCGTTGG
GAATGGAGAGGCGCTCCCC -> AATGGAGAGGCGCTCCCCA
GTTGTTGGTGGTATGTAAG -> TTGTTGGTGGTATGTAAGA
GGCAATTGCTTCTGTACGG -> GCAATTGCTTCTGTACGGG
GGGCTAGTGCGTGGTACAT -> GGCTAGTGCGTGGTACATA
TTGATGCGATGGGGTCCTA -> TGATGCGATGGGGTCCTAG
GAGTTCATCACACTGGCTG -> AGTTCATCACACTGGCTGG
TTAGGTTGGTATTCTGAAG -> TAGGTTGGTATTCTGAAGC
CGTAAACACGAGCTAGTGA -> GTAAACACGAGCTAGTGAT
CTCCCTACTTAACCTGGGA -> TCCCTACTTAACCTGGGAC
ACCATCATATTAAAGTTAC -> CCATCATATTAAAGTTACA
CCGTCCTTATTATCCTGCT -> CGTCCTTATTATCCTGCTC
TCGTGCCAACCTCCCTGTT -> CGTGCCAACCTCCCTGTTG
CCACCGCGGCGGGGGTATC -> CACCGCGGCGGGGGTATCT
GATCACGCGAGACAGTGAG -> ATCACGCGAGACAGTGAGT
TGGGGCACAGCTGACTCGA -> GGGGCACAGCTGACTCGAG
ATGCGACGTGTACATTATC -> TGCGACGTGTACATTATCG
AGTGGGCAGGTGGACGGAA -> GTGGGCAGGTGGACGGAAT
CGGTAAAAACAGCGTCCTG -> GGTAAAAACAGCGTCCTGG
AGCTAAGATTAGAACCTCG -> GCTAAGATTAGAACCTCGC
CCTCTGACGACAACGTATA -> CTCTGACGACAACGTATAG
AGGTTCAAGTATTCGGGGC -> GGTTCAAGTATTCGGGGCT
TGCCAAGCGTTACCTTCCA -> GCCAAGCGTTACCTTCCAG
CATTATCGATTCGCATTGT -> ATTATCGATTCGCATTGTG
TCTTCGTCAGTCCCGTAAG -> CTTCGTCAGTCCCGTAAGA
GTGTGCCGCGACTAAAGCG -> TGTGCCGCGACTAAAGCGT
ATACAAGGATAGCTCGGAG -> TACAAGGATAGCTCGGAGC
CACTCCATTACGCCAAGAG -> ACTCCATTACGCCAAGAGA
TAAAAGAACCCAGGTGTTA -> AAAAGAACCCAGGTGTTAC
GAACGGGATGAAGGTCGGT -> AACGGGATGAAGGTCGGTT
TATTCTAGGCATTATGCTC -> ATTCTAGGCATTATGCTCG
CCTAGCGACTACCCGGTTA -> CTAGCGACTACCCGGTTAT
GTGTGTTTTTCCATTAGAT -> TGTGTTTTTCCATTAGATT
GAACCCACAATCACTCCAT -> AACCCACAATCACTCCATT
GGCATTCGCCACCAGCCCT -> GCATTCGCCACCAGCCCTC
GGTGGACGGAATCCTACAA -> GTGGACGGAATCCTACAAT
GTGAACATATGGACGGAAA -> TGAACATATGGACGGAAAC
GGGTCCTCGTAGCCATCGA -> GGTCCTCGTAGCCATCGAC
ACCTGCCCGGCCACGACCG -> CCTGCCCGGCCACGACCGC
ATAGGTGTGTACGTACGTA -> TAGGTGTGTACGTACGTAA
TTAGATTCGTGCGTAACCC -> TAGATTCGTGCGTAACCCC
TCCGTCCTTATTATCCTGC -> CCGTCCTTATTATCCTGCT
CATTAGATTCGTGCGTAAC -> ATTAGATTCGTGCGTAACC
GCGTATTTTGTGTTTATAA -> CGTATTTTGTGTTTATAAG
CTATTGAAAATACCTAGAA -> TATTGAAAATACCTAGAAC
CCACAATCGTCGTGCCAAC -> CACAATCGTCGTGCCAACC
GCTCATGCTTTCACGTCCC -> CTCATGCTTTCACGTCCCA
GGGGACCTGCCCGGCCACG -> GGGACCTGCCCGGCCACGA
GTCCTTATTATCCTGCTCA -> TCCTTATTATCCTGCTCAG
ACTCTGGTGCTGCGATCCA -> CTCTGGTGCTGCGATCCAT
ACATGCATCCACAATCGTC -> CATGCATCCACAATCGTCG
AAGAAGCTCTCCCTACTTA -> AGAAGCTCTCCCTACTTAA
ACATTATCGATTCGCATTG -> CATTATCGATTCGCATTGT
ACTGGCTGGGGAAAGCCAG -> CTGGCTGGGGAAAGCCAGT
TTCCTGATTGCGCATACGT -> TCCTGATTGCGCATACGTA
TGCGATCCATGCTCGTCAA -> GCGATCCATGCTCGTCAAG
TTAGGACGGGTGCCTTCTA -> TAGGACGGGTGCCTTCTAT
CGATTCGCATTCCTGATTG -> GATTCGCATTCCTGATTGC
GTGCGTGGTACATAGTCTA -> TGCGTGGTACATAGTCTAT
GAGCTAGATTCAGGCTGTG -> AGCTAGATTCAGGCTGTGC
TAACGCAAATATCCGTCCT -> AACGCAAATATCCGTCCTT
TTGTAGGGTCGCCGGGCTT -> TGTAGGGTCGCCGGGCTTG
CCATCGTAACGTACCACTG -> CATCGTAACGTACCACTGA
TTATCATCGCGGTATTCAA -> TATCATCGCGGTATTCAAA
TTCGTGCGTAACCCCCCCT -> TCGTGCGTAACCCCCCCTG
TGTTGAACGGGATGAAGGT -> GTTGAACGGGATGAAGGTC
TTACATCTCGGGATACCTG -> TACATCTCGGGATACCTGC
GCCTCCAGTGCGATTCTTA -> CCTCCAGTGCGATTCTTAT
CCATGCTCGTCAAGTTGGG -> CATGCTCGTCAAGTTGGGG
TGAGGGTGTGCCGCGACTA -> GAGGGTGTGCCGCGACTAA
TCCATTAGATTCGTGCGTA -> CCATTAGATTCGTGCGTAA
TATTATCCTGCTGTTACTC -> ATTATCCTGCTGTTACTCC
GATAAGTTTCCTCTTTGAT -> ATAAGTTTCCTCTTTGATT
TACGGTCATAACATGGCAA -> ACGGTCATAACATGGCAAT
ATCGTAACGTACCACTGAG -> TCGTAACGTACCACTGAGA
TACGCCGACGTGGGCTAGT -> ACGCCGACGTGGGCTAGTG
GTGATCGACGTTGTTGGTG -> TGATCGACGTTGTTGGTGG
TTGGTATTCTGAAGCATGT -> TGGTATTCTGAAGCATGTA
ATAAGCTGTAGCGTCCTTA -> TAAGCTGTAGCGTCCTTAT
TAGGCATTCGCCACCAGCC -> AGGCATTCGCCACCAGCCC
CAATGGAGCGCAGCTCATA -> AATGGAGCGCAGCTCATAG
TGCTCGACCACCGCGGCGG -> GCTCGACCACCGCGGCGGG
AAGCCAGTGTAGCGTGGCT -> AGCCAGTGTAGCGTGGCTT
TGTGTCCCCGCGACCAAAC -> GTGTCCCCGCGACCAAACC
GACGGAAACAAGCTGCCAA -> ACGGAAACAAGCTGCCAAA
TGTCAGTCGGTCTTAGGCA -> GTCAGTCGGTCTTAGGCAT
TACTCCCGGGTACATTATC -> ACTCCCGGGTACATTATCG
CTCATGCTTTCACGTCCCA -> TCATGCTTTCACGTCCCAT
TTAGGCATTCGCCACCAGC -> TAGGCATTCGCCACCAGCC
CTTCTGTACGGGTCTGGTG -> TTCTGTACGGGTCTGGTGG
ACGTATTATCATCGCGGTA -> CGTATTATCATCGCGGTAT
CCCCCTGCAGGATTATTTT -> CCCCTGCAGGATTATTTTA
GCAAAGGAGCGTGTTACGG -> CAAAGGAGCGTGTTACGGT
GAACATATGGACGGAAACA -> AACATATGGACGGAAACAA
AAGTATTCGGGGCTAACCA -> AGTATTCGGGGCTAACCAT
GTTTCCTCTTTGATTAAAC -> TTTCCTCTTTGATTAAACT
GTTACGGTCATAACATGGC -> TTACGGTCATAACATGGCA
AGAACCTCGCACCAAGACT -> GAACCTCGCACCAAGACTG
CGTGCGCATGACCCAATCA -> GTGCGCATGACCCAATCAT
AACAGGCCTGTGGAGTGCT -> ACAGGCCTGTGGAGTGCTT
TTGTCATAGGTGTGTACGT -> TGTCATAGGTGTGTACGTA
CGAATGGAGAGGCGCTCCC -> GAATGGAGAGGCGCTCCCC
TAGGTGGCGTGCGCATGAC -> AGGTGGCGTGCGCATGACC
ATCCTGCTCAGCACCTGGA -> TCCTGCTCAGCACCTGGAG
AGTCGTCCGAACACACCGG -> GTCGTCCGAACACACCGGC
CTAAATTACCCAGAAGTCA -> TAAATTACCCAGAAGTCAA
GATCCATGCTCGTCAAGTT -> ATCCATGCTCGTCAAGTTG
TAAGAGAGCTAGATTCAGG -> AAGAGAGCTAGATTCAGGC
AACATATGGACGGAAACAA -> ACATATGGACGGAAACAAG
AGAACCCAGGTGTTACCAC -> GAACCCAGGTGTTACCACA
CAGTAGTCTACCTAGCGAC -> AGTAGTCTACCTAGCGACT
ATATTAAAGTTACACAACA -> TATTAAAGTTACACAACAG
AGCCAGTGTAGCGTGGCTT -> GCCAGTGTAGCGTGGCTTA
GGTCTGCTATGAGAATACT -> GTCTGCTATGAGAATACTC
ACACCGGCGTTGACTACGA -> CACCGGCGTTGACTACGAC
ATGCTCGTCAAGTTGGGGC -> TGCTCGTCAAGTTGGGGCA
GCCACTGGCGACCTCGTAC -> CCACTGGCGACCTCGTACT
CGACCACCGCGGCGGGGGT -> GACCACCGCGGCGGGGGTA
CCCATAAATATTGTCATAG -> CCATAAATATTGTCATAGG
TTTGAGTTCATCACACTGG -> TTGAGTTCATCACACTGGC
TGTAAAGCCCGTTAGGTTT -> GTAAAGCCCGTTAGGTTTT
CGCGTTTTTAAGTGTGTGT -> GCGTTTTTAAGTGTGTGTC
TCATATTAAAGTTACACAA -> CATATTAAAGTTACACAAC
TGGTAATTCTGATCAATGG -> GGTAATTCTGATCAATGGA
GGTTTTAGTGGACCATCAT -> GTTTTAGTGGACCATCATA
GCATTCCTGATTGCGCATA -> CATTCCTGATTGCGCATAC
CCCTGCAGGATTATTTTAT -> CCTGCAGGATTATTTTATT
TACGGGTCTGGTGGCCGGT -> ACGGGTCTGGTGGCCGGTA
GAAGGTCGGTTATGCCACT -> AAGGTCGGTTATGCCACTG
GGCGGGGGTATCTATTGGT -> GCGGGGGTATCTATTGGTA
TAGTCGTCCTTATTATCCT -> AGTCGTCCTTATTATCCTG
GGGTGTGCCGCGACTAAAG -> GGTGTGCCGCGACTAAAGC
ACTTAGTTAGGTGGGGTGG -> CTTAGTTAGGTGGGGTGGC
TATAGTCGTGGCCAGTAGT -> ATAGTCGTGGCCAGTAGTC
GCGACCAAACCCCCTGGCA -> CGACCAAACCCCCTGGCAA
AAACAACCGGAGTGGGCAG -> AACAACCGGAGTGGGCAGG
TATCGATTCGCATTGTGTG -> ATCGATTCGCATTGTGTGT
CGCGTAAACACGAGCTAGT -> GCGTAAACACGAGCTAGTG
CGCGATATACAAGGATAGC -> GCGATATACAAGGATAGCT
TCGCCCTGTGGAGAGACTC -> CGCCCTGTGGAGAGACTCT
TCCCCATATCGCCATCAGA -> CCCCATATCGCCATCAGAA
GCTTCTGTACGGGTCTGGT -> CTTCTGTACGGGTCTGGTG
TCTGAGAGATTCTATTGAA -> CTGAGAGATTCTATTGAAA
AAATGTCAGTCGGTCTTAG -> AATGTCAGTCGGTCTTAGG
CCACGACCGCGTAAACACG -> CACGACCGCGTAAACACGA
GAGTGCTTGCTACTGAAAT -> AGTGCTTGCTACTGAAATG
GGTGGTATGTAAGAGAGCT -> GTGGTATGTAAGAGAGCTA
TCATCACACTGGCTGGGGA -> CATCACACTGGCTGGGGAA
CAGAAGTCAAACCCGGGTA -> AGAAGTCAAACCCGGGTAA
GTAATGCCAAGCGTTACCT -> TAATGCCAAGCGTTACCTT
GCTGTAGCGTCCTTATTAT -> CTGTAGCGTCCTTATTATC
CAAGTATTCGGGGCTAACC -> AAGTATTCGGGGCTAACCA
GCTCGACCACCGCGGCGGG -> CTCGACCACCGCGGCGGGG
CGGTATTCAAAATGAAGAG -> GGTATTCAAAATGAAGAGG
ATCTCGGGATACCTGCGCC -> TCTCGGGATACCTGCGCCG
TTAAACTTAGTTAGGTGGG -> TAAACTTAGTTAGGTGGGG
AGCTCTTACGTAATAGATC -> GCTCTTACGTAATAGATCA
ATGTGAGGGCATGAGGGTG -> TGTGAGGGCATGAGGGTGT
CCCTGCGTTGACCGCGTAT -> CCTGCGTTGACCGCGTATT
GTGCCGCGACTAAAGCGTC -> TGCCGCGACTAAAGCGTCG
AAGTCAGTATGGTTATGTC -> AGTCAGTATGGTTATGTCC
TCTACCTAGCGACTACCCG -> CTACCTAGCGACTACCCGG
CATGAGTGAACATATGGAC -> ATGAGTGAACATATGGACG
TCGTGTACGAGAGGTCTGC -> CGTGTACGAGAGGTCTGCT
GATATCGGTTACATCTCGG -> ATATCGGTTACATCTCGGG
TCGTGGCCAGTAGTCTACC -> CGTGGCCAGTAGTCTACCT
TTCGTCAGTCCCGTAAGAA -> TCGTCAGTCCCGTAAGAAC
TAGCGTCCTTATTATCCTG -> AGCGTCCTTATTATCCTGC
GTGTATGACGGCCGACCAC -> TGTATGACGGCCGACCACT
GAAGATGGCAGGCAAAGGA -> AAGATGGCAGGCAAAGGAG
CCTGCAGGATTATTTTATT -> CTGCAGGATTATTTTATTC
TAAGAACCCCGGAGGTTCA -> AAGAACCCCGGAGGTTCAA
GTCCCATAAATATTGTCAT -> TCCCATAAATATTGTCATA
TCGGTCTTAGGCATTCGCC -> CGGTCTTAGGCATTCGCCA
TATTATCATCGCGGTATTC -> ATTATCATCGCGGTATTCA
GCAGGCAAAGGAGCGTGTT -> CAGGCAAAGGAGCGTGTTA
TTGACTACGACCTAGTCGT -> TGACTACGACCTAGTCGTC
CTCCAGTGCGATTCTTATG -> TCCAGTGCGATTCTTATGC
CTCGACCACCGCGGCGGGG -> TCGACCACCGCGGCGGGGG
AGATTGATATTTATCTCTA -> GATTGATATTTATCTCTAC
CTGGCAAACAACCGGAGTG -> TGGCAAACAACCGGAGTGG
GCGTTGACCGCGTATTTTG -> CGTTGACCGCGTATTTTGT
TCGCATTGTGTGTTTTTCC -> CGCATTGTGTGTTTTTCCA
CCATATCGCCATCAGAAGA -> CATATCGCCATCAGAAGAT
GAGACTCTGGTGCTGCGAT -> AGACTCTGGTGCTGCGATC
GAGCGCAGCTCATAGGTGG -> AGCGCAGCTCATAGGTGGC
ATTACCCAGAAGTCAAACC -> TTACCCAGAAGTCAAACCC
AGTTAGGTGGGGTGGCAAT -> GTTAGGTGGGGTGGCAATT
AGCTCATAGGTGGCGTGCG -> GCTCATAGGTGGCGTGCGC
TTACCGAGTAAGTCAGTAT -> TACCGAGTAAGTCAGTATG
AGAACCCACAATCACTCCA -> GAACCCACAATCACTCCAT
TATCCTGCTTGATGCGACG -> ATCCTGCTTGATGCGACGT
AGCTGGGCTGCTTCGTCAC -> GCTGGGCTGCTTCGTCACG
TTATGCCCTATCGACGTTG -> TATGCCCTATCGACGTTGC
ACGGGATGAAGGTCGGTTA -> CGGGATGAAGGTCGGTTAT
TTTTGTGTTTATAAGCTGT -> TTTGTGTTTATAAGCTGTA
CCTCAGTGTATGACGGCCG -> CTCAGTGTATGACGGCCGA
GTGTCCCCGCGACCAAACC -> TGTCCCCGCGACCAAACCC
ATTCTAGGCATTATGCTCG -> TTCTAGGCATTATGCTCGA
CACTGGGTCATTCCGCGTT -> ACTGGGTCATTCCGCGTTT
GCTTGCTACTGAAATGTCA -> CTTGCTACTGAAATGTCAG
GCATACGTATTATCATCGC -> CATACGTATTATCATCGCG
GTGCGATTCTTATGCCCTA -> TGCGATTCTTATGCCCTAT
CCTGTGGAGAGACTCTGGT -> CTGTGGAGAGACTCTGGTG
ACGTCCTTATTATCCTGCT -> CGTCCTTATTATCCTGCTA
ACGTAATGCCTCCAGTGCG -> CGTAATGCCTCCAGTGCGA
AGTATTCGGGGCTAACCAT -> GTATTCGGGGCTAACCATG
GGCCTGTGGAGTGCTTGCT -> GCCTGTGGAGTGCTTGCTA
GCTCCCTCGCCCTCAGTGT -> CTCCCTCGCCCTCAGTGTA
TGCTCCCTCGCCCTCAGTG -> GCTCCCTCGCCCTCAGTGT
CCTCGCCCTCAGTGTATGA -> CTCGCCCTCAGTGTATGAC
AATGCCTCCAGTGCGATTC -> ATGCCTCCAGTGCGATTCT
GTTACTCCCGGGTACATTA -> TTACTCCCGGGTACATTAT
CACCGCGGCGGGGGTATCT -> ACCGCGGCGGGGGTATCTA
ACAAGCTGCCAAAGCCCAA -> CAAGCTGCCAAAGCCCAAC
ATCCTGCTACTGTCGTTGT -> TCCTGCTACTGTCGTTGTG
CACCTTTCGGGTAATGCCA -> ACCTTTCGGGTAATGCCAA
TGAAGGTCGGTTATGCCAC -> GAAGGTCGGTTATGCCACT
TCATAGGTGTGTACGTACG -> CATAGGTGTGTACGTACGT
GCGTGGTACATAGTCTATG -> CGTGGTACATAGTCTATGT
TGAGTGAACATATGGACGG -> GAGTGAACATATGGACGGA
CCTAGTCGTCCTTATTATC -> CTAGTCGTCCTTATTATCC
GGCAAACAACCGGAGTGGG -> GCAAACAACCGGAGTGGGC
ATTATCGATTCGCATTCCT -> TTATCGATTCGCATTCCTG
AGTCTACCTAGCGACTACC -> GTCTACCTAGCGACTACCC
ACGTGGGCTAGTGCGTGGT -> CGTGGGCTAGTGCGTGGTA
GATTCGTGCGTAACCCCCC -> ATTCGTGCGTAACCCCCCC
CAAGTTGGGGCACAGCTGA -> AAGTTGGGGCACAGCTGAC
TCATAACATGGCAATTGGC -> CATAACATGGCAATTGGCC
GATGGCAGGCAAAGGAGCG -> ATGGCAGGCAAAGGAGCGT
CCTCGGTTGAAACGAATGG -> CTCGGTTGAAACGAATGGA
TTATGTCCATCGTAACGTA -> TATGTCCATCGTAACGTAC
GTGGACCATCATATTAAAG -> TGGACCATCATATTAAAGT
TAGGCATTATGCTCGACCA -> AGGCATTATGCTCGACCAC
ACCCACCGCTGCATCGTGT -> CCCACCGCTGCATCGTGTC
ACGACCGCGTAAACACGAG -> CGACCGCGTAAACACGAGC
CAGTCCCGTAAGAACCCCG -> AGTCCCGTAAGAACCCCGG
GGCCGGTAAAAACAGCGTC -> GCCGGTAAAAACAGCGTCC
GATGGGGTCCTAGCGTTGG -> ATGGGGTCCTAGCGTTGGA
ATGCTTTCACGTCCCATAA -> TGCTTTCACGTCCCATAAA
AGGTTTTTGTAAAGCCCGT -> GGTTTTTGTAAAGCCCGTT
TATCGATTCGCATTCTTAG -> ATCGATTCGCATTCTTAGG
CATAACATGGCAATTGGCC -> ATAACATGGCAATTGGCCC
AGAGATTCTATTGAAAATA -> GAGATTCTATTGAAAATAC
GCTCTCCCTACTTAACCTG -> CTCTCCCTACTTAACCTGG
CCATCATATTAAAGTTACA -> CATCATATTAAAGTTACAC
TGGTACATAGTCTATGTTA -> GGTACATAGTCTATGTTAG
ATGAGAATACTCTGAGAGA -> TGAGAATACTCTGAGAGAT
CCTCCCTGTTGAACGGGAT -> CTCCCTGTTGAACGGGATG
GAAGAAGCTGGGCTGCTTC -> AAGAAGCTGGGCTGCTTCG
ACTATCTTCACTCGCCCTG -> CTATCTTCACTCGCCCTGT
CCGCGATATACAAGGATAG -> CGCGATATACAAGGATAGC
AGGTTGGTATTCTGAAGCA -> GGTTGGTATTCTGAAGCAT
CAGAAGGGGGACCTGCCCG -> AGAAGGGGGACCTGCCCGG
CATTGTGTGTTTTTCCATT -> ATTGTGTGTTTTTCCATTA
GTTATGTCCATCGTAACGT -> TTATGTCCATCGTAACGTA
CCCTAACGCAAATATCCGT -> CCTAACGCAAATATCCGTC
CAAAATGAAGAGGTTTTTG -> AAAATGAAGAGGTTTTTGT
ATATCCGTCCTTATTATCC -> TATCCGTCCTTATTATCCT
GCATCGTGTCCGCCGACTT -> CATCGTGTCCGCCGACTTA
TTCTTCGTCAGTCCCGTAA -> TCTTCGTCAGTCCCGTAAG
TTAGGTGGGGTGGCAATTG -> TAGGTGGGGTGGCAATTGC
TAAACACGAGCTAGTGATC -> AAACACGAGCTAGTGATCG
CATCCACAATCGTCGTGCC -> ATCCACAATCGTCGTGCCA
TTCGCATTCCTGATTGCGC -> TCGCATTCCTGATTGCGCA
TCCGCCGACTTAGGTTGGT -> CCGCCGACTTAGGTTGGTA
CGCATTCCTGATTGCGCAT -> GCATTCCTGATTGCGCATA
TTTAAAAGAACCCAGGTGT -> TTAAAAGAACCCAGGTGTT
CCCCCCCTGCAGGATTATT -> CCCCCCTGCAGGATTATTT
CATATTAAAGTTACACAAC -> ATATTAAAGTTACACAACA
ATGTCCATCGTAACGTACC -> TGTCCATCGTAACGTACCA
CTGCTTCGTCACGAACGAT -> TGCTTCGTCACGAACGATT
CTGAGAGATTCTATTGAAA -> TGAGAGATTCTATTGAAAA
GCAGGATTATTTTATTCTA -> CAGGATTATTTTATTCTAG
TATCTTCACTCGCCCTGTG -> ATCTTCACTCGCCCTGTGG
GTGGCTTACTGCGCCTTGT -> TGGCTTACTGCGCCTTGTA
CGGTCTTAGGCATTCGCCA -> GGTCTTAGGCATTCGCCAC
ACTGGGTCATTCCGCGTTT -> CTGGGTCATTCCGCGTTTT
CGCATGACCCAATCATGAG -> GCATGACCCAATCATGAGT
GCTGACTCGAGTTGCCGGC -> CTGACTCGAGTTGCCGGCT
AGGCATTATGCTCGACCAC -> GGCATTATGCTCGACCACC
GTCATTCCGCGTTTTTAAG -> TCATTCCGCGTTTTTAAGT
CTGTGGAGAGACTCTGGTG -> TGTGGAGAGACTCTGGTGC
AAGATATCGGTTACATCTC -> AGATATCGGTTACATCTCG
ATTGGCCCTGCGTTGACCG -> TTGGCCCTGCGTTGACCGC
CGCGGCGGGGGTATCTATT -> GCGGCGGGGGTATCTATTG
AGGTCGGTTATGCCACTGG -> GGTCGGTTATGCCACTGGC
GTTACACAACAGGCCTGTG -> TTACACAACAGGCCTGTGG
AGCGGGCTCATGCTTTCAC -> GCGGGCTCATGCTTTCACG
CTAAAGCGTCGAGCGGGCT -> TAAAGCGTCGAGCGGGCTC
TATCTCTACCCACCGCTGC -> ATCTCTACCCACCGCTGCA
AGGAGCGTGTTACGGTCAT -> GGAGCGTGTTACGGTCATA
TAAGTCAGTATGGTTATGT -> AAGTCAGTATGGTTATGTC
TTATCGATTCGCATTCCTG -> TATCGATTCGCATTCCTGA
GGCTTGATTACCGAGTAAG -> GCTTGATTACCGAGTAAGT
TGGTATTCTGAAGCATGTA -> GGTATTCTGAAGCATGTAT
CTGCGCCGCGATATACAAG -> TGCGCCGCGATATACAAGG
CAGTGCGATTCTTATGCCC -> AGTGCGATTCTTATGCCCT
TGGTTATGTCCATCGTAAC -> GGTTATGTCCATCGTAACG
GCGATCCATGCTCGTCAAG -> CGATCCATGCTCGTCAAGT
TAATTCTGATCAATGGAGC -> AATTCTGATCAATGGAGCG
CTACTTAACCTGGGACGTC -> TACTTAACCTGGGACGTCC
CTTGCTACTGAAATGTCAG -> TTGCTACTGAAATGTCAGT
GACAACGTATAGTCGTGGC -> ACAACGTATAGTCGTGGCC
TAGACAGTTTCAGTCGTCC -> AGACAGTTTCAGTCGTCCG
TAAAGTTACACAACAGGCC -> AAAGTTACACAACAGGCCT
GTCAGTCCCGTAAGAACCC -> TCAGTCCCGTAAGAACCCC
TTGCTACTGAAATGTCAGT -> TGCTACTGAAATGTCAGTC
ACGAGAGGTCTGCTATGAG -> CGAGAGGTCTGCTATGAGA
CTACTGTCGTTGTGTACAT -> TACTGTCGTTGTGTACATT
TGTTAGATTGATATTTATC -> GTTAGATTGATATTTATCT
TAGTCGTGGCCAGTAGTCT -> AGTCGTGGCCAGTAGTCTA
CTCTACCCACCGCTGCATC -> TCTACCCACCGCTGCATCG
TTTTGTAAAGCCCGTTAGG -> TTTGTAAAGCCCGTTAGGT
CGGGTAATGCCAAGCGTTA -> GGGTAATGCCAAGCGTTAC
GCACCAAGACTGGGGGTCC -> CACCAAGACTGGGGGTCCT
CCGACCACTGGGTCATTCC -> CGACCACTGGGTCATTCCG
GCCCTGCGTTGACCGCGTA -> CCCTGCGTTGACCGCGTAT
CTGACTCGAGTTGCCGGCT -> TGACTCGAGTTGCCGGCTG
ATGACCCAATCATGAGTGA -> TGACCCAATCATGAGTGAA
CGTATTTTGTGTTTATAAG -> GTATTTTGTGTTTATAAGC
CGTGTCCGCCGACTTAGGT -> GTGTCCGCCGACTTAGGTT
TACTCTGAGAGATTCTATT -> ACTCTGAGAGATTCTATTG
AGAGACTATCTTCACTCGC -> GAGACTATCTTCACTCGCC
ATAGGTGGCGTGCGCATGA -> TAGGTGGCGTGCGCATGAC
ACCAGCCCTCTGACGACAA -> CCAGCCCTCTGACGACAAC
AACCTCGCACCAAGACTGG -> ACCTCGCACCAAGACTGGG
ACCAAGACTGGGGGTCCTC -> CCAAGACTGGGGGTCCTCG
TTTTAGTGGACCATCATAT -> TTTAGTGGACCATCATATT
GCCCTCAGTGTATGACGGC -> CCCTCAGTGTATGACGGCC
CTTTCACGTCCCATAAATA -> TTTCACGTCCCATAAATAT
ATATCGCCATCAGAAGATA -> TATCGCCATCAGAAGATAT
CTTCGTCACGAACGATTTA -> TTCGTCACGAACGATTTAA
GATGCGACGTGTACATTAT -> ATGCGACGTGTACATTATC
GTGGAGAGACTCTGGTGCT -> TGGAGAGACTCTGGTGCTG
CAGGATTATTTTATTCTAG -> AGGATTATTTTATTCTAGG
AATACCTAGAACCCACAAT -> ATACCTAGAACCCACAATC
GATTTAAAAGAACCCAGGT -> ATTTAAAAGAACCCAGGTG
TAGCCATCGACAGTGCTGC -> AGCCATCGACAGTGCTGCA
TTCTATTTGAGTTCATCAC -> TCTATTTGAGTTCATCACA
CGACCTCGTACTTTGATGC -> GACCTCGTACTTTGATGCG
CGTCGTGCCAACCTCCCTG -> GTCGTGCCAACCTCCCTGT
CATCATATTAAAGTTACAC -> ATCATATTAAAGTTACACA
CCCATATCGCCATCAGAAG -> CCATATCGCCATCAGAAGA
CGTCAATCTTCTTCGTCAG -> GTCAATCTTCTTCGTCAGT
AAAAACAGCGTCCTGGATA -> AAAACAGCGTCCTGGATAC
ACGTAATAGATCACGCGAG -> CGTAATAGATCACGCGAGA
GCCGGGCTTGATTACCGAG -> CCGGGCTTGATTACCGAGT
CGCCCTCAGTGTATGACGG -> GCCCTCAGTGTATGACGGC
AGTTGCCGGCTGATAAGTT -> GTTGCCGGCTGATAAGTTT
ATGTATAGGCTCCCTTAGA -> TGTATAGGCTCCCTTAGAC
CCCTACTTAACCTGGGACG -> CCTACTTAACCTGGGACGT
GGTGGCCGGTAAAAACAGC -> GTGGCCGGTAAAAACAGCG
GAAGATATCGGTTACATCT -> AAGATATCGGTTACATCTC
CGGAGTGGGCAGGTGGACG -> GGAGTGGGCAGGTGGACGG
GTTGGTATTCTGAAGCATG -> TTGGTATTCTGAAGCATGT
AATGTCAGTCGGTCTTAGG -> ATGTCAGTCGGTCTTAGGC
GCTAGATTCAGGCTGTGCT -> CTAGATTCAGGCTGTGCTC
GTTGACCGCGTATTTTGTG -> TTGACCGCGTATTTTGTGT
TTCCATTAGATTCGTGCGT -> TCCATTAGATTCGTGCGTA
TTGATGCGACGTGTACATT -> TGATGCGACGTGTACATTA
TACCTAGAACCCACAATCA -> ACCTAGAACCCACAATCAC
GTCTACCTAGCGACTACCC -> TCTACCTAGCGACTACCCG
ATTTTGTGTTTATAAGCTG -> TTTTGTGTTTATAAGCTGT
TTCGGGGCTAACCATGTGA -> TCGGGGCTAACCATGTGAG
CCCCTAACGCAAATATCCG -> CCCTAACGCAAATATCCGT
CACAGAAGATGGCAGGCAA -> ACAGAAGATGGCAGGCAAA
TGAAAATACCTAGAACCCA -> GAAAATACCTAGAACCCAC
TGAGGGACAACAGAAGGGG -> GAGGGACAACAGAAGGGGG
GCTTACTGCGCCTTGTAGG -> CTTACTGCGCCTTGTAGGG
CGGTTACATCTCGGGATAC -> GGTTACATCTCGGGATACC
TATCCTGCTCAGCACCTGG -> ATCCTGCTCAGCACCTGGA
GAGGTTTTTGTAAAGCCCG -> AGGTTTTTGTAAAGCCCGT
CGTGGCTTACTGCGCCTTG -> GTGGCTTACTGCGCCTTGT
ATCGACGTTGCTTCCCTCC -> TCGACGTTGCTTCCCTCCG
TACTGAAATGTCAGTCGGT -> ACTGAAATGTCAGTCGGTC
TGAAGCATGTATAGGCTCC -> GAAGCATGTATAGGCTCCC
GGGACGTCCTTATTATCCT -> GGACGTCCTTATTATCCTG
ATAGCTCGGAGCTCTTACG -> TAGCTCGGAGCTCTTACGT
GGTTACATCTCGGGATACC -> GTTACATCTCGGGATACCT
CGCCACCAGCCCTCTGACG -> GCCACCAGCCCTCTGACGA
ACCACAGAAGATGGCAGGC -> CCACAGAAGATGGCAGGCA
CCCGGCCACGACCGCGTAA -> CCGGCCACGACCGCGTAAA
GCCATCAGAAGATATCGGT -> CCATCAGAAGATATCGGTT
CAAAGGAGCGTGTTACGGT -> AAAGGAGCGTGTTACGGTC
ACATCTCGGGATACCTGCG -> CATCTCGGGATACCTGCGC
CTTAGGCATTCGCCACCAG -> TTAGGCATTCGCCACCAGC
GCATTCTTAGGACGGGTGC -> CATTCTTAGGACGGGTGCC
CGGTCATAACATGGCAATT -> GGTCATAACATGGCAATTG
TCCGAACACACCGGCGTTG -> CCGAACACACCGGCGTTGA
GAGGGCATGAGGGTGTGCC -> AGGGCATGAGGGTGTGCCG
AAAGTTACACAACAGGCCT -> AAGTTACACAACAGGCCTG
GCTTGATGCGACGTGTACA -> CTTGATGCGACGTGTACAT
ACTCGAGTTGCCGGCTGAT -> CTCGAGTTGCCGGCTGATA
TCTGACGACAACGTATAGT -> CTGACGACAACGTATAGTC
CCGGTAAAAACAGCGTCCT -> CGGTAAAAACAGCGTCCTG
GCGACCTCGTACTTTGATG -> CGACCTCGTACTTTGATGC
AAGTGTGTGTCCCCGCGAC -> AGTGTGTGTCCCCGCGACC
TGGCGACCTCGTACTTTGA -> GGCGACCTCGTACTTTGAT
CTGCTGTTACTCCCGGGTA -> TGCTGTTACTCCCGGGTAC
GCCATCGACAGTGCTGCAG -> CCATCGACAGTGCTGCAGC
ATTATCGATTCGCATTCTT -> TTATCGATTCGCATTCTTA
CCCACAATCACTCCATTAC -> CCACAATCACTCCATTACG
CAAACCCGGGTAAGAAGCT -> AAACCCGGGTAAGAAGCTC
GGAGAGACTCTGGTGCTGC -> GAGAGACTCTGGTGCTGCG
ACCTAGAACCCACAATCAC -> CCTAGAACCCACAATCACT
TAACCCCCCCTGCAGGATT -> AACCCCCCCTGCAGGATTA
TCCTCGGTTGAAACGAATG -> CCTCGGTTGAAACGAATGG
CGCGGTATTCAAAATGAAG -> GCGGTATTCAAAATGAAGA
