30 100
GCCAGATGTGGATTCACGCAGTAAACACCC|CCTCATGAATCCGTTTTGACCCACACCCTC
TGGTAACACCCTCGCGAGCGCCAAGCGACG|AATCGACACCCTCGCGAGCGCCAAGCGACG
AATACACCTAGCTCGGTTTCTGCAAATCTC|GCGACGAGCCAGCCAAGCGACGAGCCAGCG
GATCGACACCCTCGCGAGCGCCAAGCGACG|ACTGCATGAGCCCACGCATACTGGCAGCAA
AAACTATTTTTAGTAGCGAATTTCACACCA|TCAGGGTGATAGCATCCGCTGTTGAGTGGG
GCGCCAAGCGACGAGCCAGAATCAGGGATT|GCGCCAAGCGACGAGCCACTCAGTGTGCTA
CGAGCCACATCACGGGGCGGAACGAGACTA|GCGAGCGCCAAGCGACGAGCCAGATGTGGA
ACTGGCAGCAACACCCTCGCGAGCGCCAAG|GCGAGCGCCAAGCGACGAGCCACGCCAAGC
TTTCTCATCGTCAAGTAAGCAGGGACCCAG|AGCCATATACACCCTCGCGAGCACACCCTC
TGGCAAATCGACACCCTCGCGAGCGCCAAG|TCGCGAGCGCCAAGCGACGAGCCACGGGTA
CCATAAGGTTCTCCTAACTTTCCATAACTC|ACCCAACACACTAGTGCTATACACGATGAG
ATGAATACACCTAGCTCGGTTTCTGCAAAT|CAAGCGACGAGCCAGCCAAGCGACGAGCCA
CATGAATCCGTTTTGACCCACACCCTCGCG|GTAACCTGCGAAGCTTCGACACCCTCGCGA
TTGAGTGTACCTGAGGTGGGTCACCTCCGT|AAGCAGGGACCCAGCTCCGAACATGAATAC
CCACATCACGGGGCGGAACGAGACTAGATT|GCGCCAAGCGACGAGCCAGATGTGGATTCA
ACTCACCTCTCTTCTCTTGGGTGCTGGTTC|CCTCGGAACACAAAGTGCCTGAAAGCAGAC
CGCCAAGCGACGAGCCACGCCAAGCGACGA|ATCACGGGGCGGAACGAGACTAGATTGCGC
CTCACGGACGCCCACCGATGTCGGCCACTG|GAGTGCCAATGCAAAGAGGAGTGTGCTCCG
TAGCTCGGTTTCTGCAAATCTCGATTCACT|CCAGCCAAGCGACGAGCCAGCGTCAACACC
GTGTACCTGAGGTGGGTCACCTCCGTAGGT|AGGGACCCAGCTCCGAACATGAATACACCT
GAGTGCCAATGCAAAGAGGAGTGTGCTCCG|CCCATCGCTTCGACCGGTCGTCTAATGCCG
AACTATTTTTAGTAGCGAATTTCACACCAG|CAGGGTGATAGCATCCGCTGTTGAGTGGGC
CCAGTGTGTGGTCGCGATGAGTGCCAATGC|GGGCGTGTCTGCACATACCCCATCGCTTCG
AGCGCCAAGCGACGAGCCAGACTTACTCGG|CGCCAAGCGACGAGCCATGCTTCCTGCCTG
GAGCCCACGCATACTGGCAGCAACACCCTC|CGAGACACCCTCGCGAGCGCCAAGCGACGA
CCCAACACACTAGTGCTATACACGATGAGT|CCGGGCGACAATGGGTTTGGAGTAGAAGGT
CAAGCGACGAGCCAGAATCAGGGATTATTA|CAAGCGACGAGCCACTCAGTGTGCTATCCG
GCGACGAGCCAGCGTCAACACCCTCGCGAG|CCCTTAGCGTCTACACCCTCGCGAGCGCCA
GCCATGCTTCCTGCCTGGCAAATCGACACC|CCACGTAATACACCCTCGCGAGCGCCAAGC
TGATGGCTTGATCTACCCTTTACTCCGTGC|CTATTTTTAGTAGCGAATTTCACACCAGTG
GGGTCACCTCCGTAGGTTCATGGCTAATAG|CGAACATGAATACACCTAGCTCGGTTTCTG
AGCGACGAGCCACTCAGTGTGCTATCCGCC|TATCCATAAGGTTCTCCTAACTTTCCATAA
CTATACACGATGAGTAGTAGGGAAACTATT|TTTGGAGTAGAAGGTATCATGCTCAGGGTG
ATGGCTTGATCTACCCTTTACTCCGTGCCT|ATTTTTAGTAGCGAATTTCACACCAGTGTG
AAGCCCAAACGGATGTTATCGATCCCTTAG|TAAAACCCGACACCCTCGCGAGCGCCAAGC
ATAAGGTTCTCCTAACTTTCCATAACTCGA|CCAACACACTAGTGCTATACACGATGAGTA
ACTAGTGCTATACACGATGAGTAGTAGGGA|CAATGGGTTTGGAGTAGAAGGTATCATGCT
AGTAGGGAAACTATTTTTAGTAGCGAATTT|ATCATGCTCAGGGTGATAGCATCCGCTGTT
CGCAGTAAACACCCTCGCGAGCGCCAAGCG|TGACCCACACCCTCGCGAGCGCCAAGCGAC
ATAGAAAGCAAAGTTCTGATCGACACCCTC|TCTGCAAATCTCGATTCACTGCATGAGCCC
GTAATACACCCTCGCGAGCGCCAAGCGACG|GGACGCCCACCGATGTCGGCCACTGCGTAG
AGCGCCAAGCGACGAGCCATATACACCCTC|ACGCCAAGCGACGAGCCACTCACCTCTCTT
ACTAGCGGATTGCCGGGCGACAATGGGTTT|TTGCAACCCCTCGATAACTTAATACTCTAT
GCCAAGCGACGAGCCAGACTTACTCGGGTA|CAAGCGACGAGCCATGCTTCCTGCCTGGCA
TAATAGAAAGCAAAGTTCTGATCGACACCC|TTTCTGCAAATCTCGATTCACTGCATGAGC
CGAATTTCACACCAGTGTGTGGTCGCGATG|CGCTGTTGAGTGGGCGTGTCTGCACATACC
CCCTCGCGAGCGCCAAGCGACGAGCCACTC|GCGACGAGCCACGGGTATCCATAAGGTTCT
CACACCCTCGCGAGCGCCAAGCGACGAGCC|ACACCCTCGCGAGCGCCAAGCGACGAGCCA
GACGAGCCAGGTCTGCTTACACACCCTCGC|AGCGCCAAGCGACGAGCCAGAATCAGGGAT
TGATCTACCCTTTACTCCGTGCCTGCAGGG|AGTAGCGAATTTCACACCAGTGTGTGGTCG
GAGTAGTAGGGAAACTATTTTTAGTAGCGA|AGGTATCATGCTCAGGGTGATAGCATCCGC
CTAATAGAAAGCAAAGTTCTGATCGACACC|GTTTCTGCAAATCTCGATTCACTGCATGAG
AAGCGACGAGCCAGATGTGGATTCACGCAG|GCGTCGTGACCTCATGAATCCGTTTTGACC
GCGACGAGCCACTCAGTGTGCTATCCGCCG|ATCCATAAGGTTCTCCTAACTTTCCATAAC
GTAAAACCCGACACCCTCGCGAGCGCCAAG|AGACTTACTCGGGTATGGTAACACCCTCGC
AGACTTACTCGGGTATGGTAACACCCTCGC|GCTTCCTGCCTGGCAAATCGACACCCTCGC
CACACCCTCGCGAGCGCCAAGCGACGAGCC|GAATCAGGGATTATTATGGCGTCGTGACCT
ACCCTCGCGAGACACCCTCGCGAGCGCCAA|CGCGAGCGCCAAGCGACGAGCCACATCACG
GTGACCTCATGAATCCGTTTTGACCCACAC|CGCTAATGTAACCTGCGAAGCTTCGACACC
GATGTGGATTCACGCAGTAAACACCCTCGC|ATGAATCCGTTTTGACCCACACCCTCGCGA
ACCTGCGAAGCTTCGACACCCTCGCGAGCG|GATGGCTTGATCTACCCTTTACTCCGTGCC
GTGTGGTCGCGATGAGTGCCAATGCAAAGA|TGTCTGCACATACCCCATCGCTTCGACCGG
GCAAAGTTCTGATCGACACCCTCGCGAGCG|ATCTCGATTCACTGCATGAGCCCACGCATA
GCCAGGTCTGCTTACACACCCTCGCGAGCG|CAAGCGACGAGCCAGAATCAGGGATTATTA
TCTCTTCTCTTGGGTGCTGGTTCGAAGCCC|ACACAAAGTGCCTGAAAGCAGACGTAAAAC
TTACTCCGTGCCTGCAGGGCCAACTCACGG|TCACACCAGTGTGTGGTCGCGATGAGTGCC
TAGAAGGTATCATGCTCAGGGTGATAGCAT|CCAGGACACCATAAATGTACCATTAGCATG
GGTCTGCTTACACACCCTCGCGAGCGCCAA|CGACGAGCCAGAATCAGGGATTATTATGGC
GGGTATCCATAAGGTTCTCCTAACTTTCCA|AACTAGACCCAACACACTAGTGCTATACAC
GTAAACACCCTCGCGAGCGCCAAGCGACGA|CCACACCCTCGCGAGCGCCAAGCGACGAGC
CCTCGCGAGCGCCAAGCGACGAGCCAGACT|TCGCGAGCGCCAAGCGACGAGCCATGCTTC
GATTGCCGGGCGACAATGGGTTTGGAGTAG|CCCTCGATAACTTAATACTCTATTGAACCA
GTTCTGATCGACACCCTCGCGAGCGCCAAG|GATTCACTGCATGAGCCCACGCATACTGGC
GAGTGTGCTCCGGCTGCCACTAGCGGATTG|CGTCTAATGCCGGGACCGTTGCAACCCCTC
ATCATGCTCAGGGTGATAGCATCCGCTGTT|CCATAAATGTACCATTAGCATGTTAATCCG
TATTTTTAGTAGCGAATTTCACACCAGTGT|GGTGATAGCATCCGCTGTTGAGTGGGCGTG
ACATGAATACACCTAGCTCGGTTTCTGCAA|GCCAAGCGACGAGCCAGCCAAGCGACGAGC
GCTCGGTTTCTGCAAATCTCGATTCACTGC|AGCCAAGCGACGAGCCAGCGTCAACACCCT
GCCAGAATCAGGGATTATTATGGCGTCGTG|GCCACTCAGTGTGCTATCCGCCGGCCTCGC
CTCGCGAGCGCCAAGCGACGAGCCACGGGT|CGATGTCGGCCACTGCGTAGCTAGGGAACT
GCGCCAAGCGACGAGCCATGCTTCCTGCCT|CGCCAAGCGACGAGCCACGTAATACACCCT
ATACACGATGAGTAGTAGGGAAACTATTTT|TGGAGTAGAAGGTATCATGCTCAGGGTGAT
GCTAGGGAACTAGACCCAACACACTAGTGC|CCACTAGCGGATTGCCGGGCGACAATGGGT
TGGCGTCGTGACCTCATGAATCCGTTTTGA|CCGGCCTCGCTAATGTAACCTGCGAAGCTT
GCTTCCTGCCTGGCAAATCGACACCCTCGC|TAATACACCCTCGCGAGCGCCAAGCGACGA
TGGCTAATAGAAAGCAAAGTTCTGATCGAC|TCGGTTTCTGCAAATCTCGATTCACTGCAT
CACCCTCGCGAGCGCCAAGCGACGAGCCAG|GGTATGGTAACACCCTCGCGAGCGCCAAGC
CACCCTCGCGAGCGCCAAGCGACGAGCCAC|CCACCGATGTCGGCCACTGCGTAGCTAGGG
TCCTAACTTTCCATAACTCGACAACTTTTA|TAGTGCTATACACGATGAGTAGTAGGGAAA
GCGGAACGAGACTAGATTGCGCGAGCCTCG|GAGCCAGATGTGGATTCACGCAGTAAACAC
TCTTGGGTGCTGGTTCGAAGCCCAAACGGA|GTGCCTGAAAGCAGACGTAAAACCCGACAC
GCGCCAAGCGACGAGCCACGGGTATCCATA|GGCCACTGCGTAGCTAGGGAACTAGACCCA
CACGCAGTAAACACCCTCGCGAGCGCCAAG|TTTGACCCACACCCTCGCGAGCGCCAAGCG
CAATGCAAAGAGGAGTGTGCTCCGGCTGCC|GCTTCGACCGGTCGTCTAATGCCGGGACCG
GCGAGCGCCAAGCGACGAGCCAGGTCTGCT|TAACACCCTCGCGAGCGCCAAGCGACGAGC
GCGAAGCTTCGACACCCTCGCGAGCGCCAA|GCTTGATCTACCCTTTACTCCGTGCCTGCA
CTGCGAAGCTTCGACACCCTCGCGAGCGCC|TGGCTTGATCTACCCTTTACTCCGTGCCTG
CGTAAAACCCGACACCCTCGCGAGCGCCAA|CAGACTTACTCGGGTATGGTAACACCCTCG
GATGTTATCGATCCCTTAGCGTCTACACCC|ACCCTCGCGAGCGCCAAGCGACGAGCCAGG
TAATGTAACCTGCGAAGCTTCGACACCCTC|CTTTTATGATGGCTTGATCTACCCTTTACT
CATAAGGTTCTCCTAACTTTCCATAACTCG|CCCAACACACTAGTGCTATACACGATGAGT
CTTCCTGCCTGGCAAATCGACACCCTCGCG|AATACACCCTCGCGAGCGCCAAGCGACGAG
GAGACTAGATTGCGCGAGCCTCGGAACACA|ATGTGGATTCACGCAGTAAACACCCTCGCG
TCGCGAGCGCCAAGCGACGAGCCACTCAGT|ACGAGCCACGGGTATCCATAAGGTTCTCCT
CTCGCGAGCGCCAAGCGACGAGCCACGTAA|ACTCCGTGCCTGCAGGGCCAACTCACGGAC
ACACCCTCGCGAGCGCCAAGCGACGAGCCA|ACACCCTCGCGAGCGCCAAGCGACGAGCCA
CTCGCGAGCGCCAAGCGACGAGCCATATAC|CGAGCCACGCCAAGCGACGAGCCACTCACC
GCTAATGTAACCTGCGAAGCTTCGACACCC|AACTTTTATGATGGCTTGATCTACCCTTTA
ACACCCTCGCGAGCGCCAAGCGACGAGCCA|AGCGACGAGCCACGCCAAGCGACGAGCCAC
ACACCCTCGCGAGCGCCAAGCGACGAGCCA|AGCGACGAGCCACATCACGGGGCGGAACGA
CTACGCCCACGGCAGTTGGTTTCTCATCGT|TCGCGAGCGCCAAGCGACGAGCCATATACA
AGCCATATACACCCTCGCGAGCACACCCTC|GCCACTCACCTCTCTTCTCTTGGGTGCTGG
ACCTCTCTTCTCTTGGGTGCTGGTTCGAAG|GGAACACAAAGTGCCTGAAAGCAGACGTAA
TATCCATAAGGTTCTCCTAACTTTCCATAA|TAGACCCAACACACTAGTGCTATACACGAT
TTCACGCAGTAAACACCCTCGCGAGCGCCA|GTTTTGACCCACACCCTCGCGAGCGCCAAG
TCGCGAGCGCCAAGCGACGAGCCACGTAAT|CTCCGTGCCTGCAGGGCCAACTCACGGACG
CGAGCCAGACTTACTCGGGTATGGTAACAC|AGCCATGCTTCCTGCCTGGCAAATCGACAC
GAACATGAATACACCTAGCTCGGTTTCTGC|GCGCCAAGCGACGAGCCAGCCAAGCGACGA
AGCGACGAGCCATGCTTCCTGCCTGGCAAA|GCGACGAGCCACGTAATACACCCTCGCGAG
CGCCAAGCGACGAGCCAGAATCAGGGATTA|CGCCAAGCGACGAGCCACTCAGTGTGCTAT
CTCGCTAATGTAACCTGCGAAGCTTCGACA|GACAACTTTTATGATGGCTTGATCTACCCT
TAGCGAATTTCACACCAGTGTGTGGTCGCG|ATCCGCTGTTGAGTGGGCGTGTCTGCACAT
GCCCACGGCAGTTGGTTTCTCATCGTCAAG|GAGCGCCAAGCGACGAGCCATATACACCCT
CATCACGGGGCGGAACGAGACTAGATTGCG|CCAAGCGACGAGCCAGATGTGGATTCACGC
CCCACGGCAGTTGGTTTCTCATCGTCAAGT|AGCGCCAAGCGACGAGCCATATACACCCTC
GTTATCGATCCCTTAGCGTCTACACCCTCG|CTCGCGAGCGCCAAGCGACGAGCCAGGTCT
GAGCCATATACACCCTCGCGAGCACACCCT|AGCCACTCACCTCTCTTCTCTTGGGTGCTG
CGGGTATCCATAAGGTTCTCCTAACTTTCC|GAACTAGACCCAACACACTAGTGCTATACA
CAAAGTTCTGATCGACACCCTCGCGAGCGC|TCTCGATTCACTGCATGAGCCCACGCATAC
CGACGAGCCAGAATCAGGGATTATTATGGC|CGACGAGCCACTCAGTGTGCTATCCGCCGG
AGTAGCGAATTTCACACCAGTGTGTGGTCG|GCATCCGCTGTTGAGTGGGCGTGTCTGCAC
CCAAGCGACGAGCCACGGGTATCCATAAGG|CACTGCGTAGCTAGGGAACTAGACCCAACA
ACACCCTCGCGAGCACACCCTCGCGAGCGC|CCTCTCTTCTCTTGGGTGCTGGTTCGAAGC
AGCCACTCAGTGTGCTATCCGCCGGCCTCG|AAGGTTCTCCTAACTTTCCATAACTCGACA
GCGAGCGCCAAGCGACGAGCCATGCTTCCT|CGAGCGCCAAGCGACGAGCCACGTAATACA
CTAGTGCTATACACGATGAGTAGTAGGGAA|AATGGGTTTGGAGTAGAAGGTATCATGCTC
TCATGGCTAATAGAAAGCAAAGTTCTGATC|AGCTCGGTTTCTGCAAATCTCGATTCACTG
GCTGGTTCGAAGCCCAAACGGATGTTATCG|AAGCAGACGTAAAACCCGACACCCTCGCGA
TTCTGCAAATCTCGATTCACTGCATGAGCC|CGACGAGCCAGCGTCAACACCCTCGCGAGA
ATTGAGTGTACCTGAGGTGGGTCACCTCCG|TAAGCAGGGACCCAGCTCCGAACATGAATA
CCCACACCCTCGCGAGCGCCAAGCGACGAG|CGACACCCTCGCGAGCGCCAAGCGACGAGC
CCCTCGCGAGCGCCAAGCGACGAGCCATAT|GACGAGCCACGCCAAGCGACGAGCCACTCA
CCTCATGAATCCGTTTTGACCCACACCCTC|AATGTAACCTGCGAAGCTTCGACACCCTCG
GCAGCAACACCCTCGCGAGCGCCAAGCGAC|GCGCCAAGCGACGAGCCACGCCAAGCGACG
ATGCTCAGGGTGATAGCATCCGCTGTTGAG|TAAATGTACCATTAGCATGTTAATCCGGAG
CAACTCACGGACGCCCACCGATGTCGGCCA|GATGAGTGCCAATGCAAAGAGGAGTGTGCT
AGCGCCAAGCGACGAGCCACTACGCCCACG|CATACTGGCAGCAACACCCTCGCGAGCGCC
ACGCATACTGGCAGCAACACCCTCGCGAGC|ACCCTCGCGAGCGCCAAGCGACGAGCCACG
CCTTAGCGTCTACACCCTCGCGAGCGCCAA|CCAAGCGACGAGCCAGGTCTGCTTACACAC
AGCGACGAGCCACGGGTATCCATAAGGTTC|TGCGTAGCTAGGGAACTAGACCCAACACAC
AAGCGACGAGCCATGCTTCCTGCCTGGCAA|AGCGACGAGCCACGTAATACACCCTCGCGA
GATCCCTTAGCGTCTACACCCTCGCGAGCG|AGCGCCAAGCGACGAGCCAGGTCTGCTTAC
CGAGCCAGATGTGGATTCACGCAGTAAACA|TGACCTCATGAATCCGTTTTGACCCACACC
CCAGAATCAGGGATTATTATGGCGTCGTGA|CCACTCAGTGTGCTATCCGCCGGCCTCGCT
TGATCGACACCCTCGCGAGCGCCAAGCGAC|CACTGCATGAGCCCACGCATACTGGCAGCA
GCAGTAAACACCCTCGCGAGCGCCAAGCGA|GACCCACACCCTCGCGAGCGCCAAGCGACG
GCTTCGACACCCTCGCGAGCGCCAAGCGAC|ATCTACCCTTTACTCCGTGCCTGCAGGGCC
AGCAACACCCTCGCGAGCGCCAAGCGACGA|GCCAAGCGACGAGCCACGCCAAGCGACGAG
GGTTCGAAGCCCAAACGGATGTTATCGATC|CAGACGTAAAACCCGACACCCTCGCGAGCG
TCACCTCCGTAGGTTCATGGCTAATAGAAA|ACATGAATACACCTAGCTCGGTTTCTGCAA
AGCGCCAAGCGACGAGCCACGGGTATCCAT|CGGCCACTGCGTAGCTAGGGAACTAGACCC
GATGGCTTGATCTACCCTTTACTCCGTGCC|TATTTTTAGTAGCGAATTTCACACCAGTGT
ACCCGACACCCTCGCGAGCGCCAAGCGACG|TACTCGGGTATGGTAACACCCTCGCGAGCG
ATCCGCCGGCCTCGCTAATGTAACCTGCGA|TCCATAACTCGACAACTTTTATGATGGCTT
GCCGGGCGACAATGGGTTTGGAGTAGAAGG|CGATAACTTAATACTCTATTGAACCAGGAC
GGCCACTGCGTAGCTAGGGAACTAGACCCA|GTGCTCCGGCTGCCACTAGCGGATTGCCGG
CCACTCAGTGTGCTATCCGCCGGCCTCGCT|GGTTCTCCTAACTTTCCATAACTCGACAAC
TACTCCGTGCCTGCAGGGCCAACTCACGGA|CACACCAGTGTGTGGTCGCGATGAGTGCCA
CGTGACCTCATGAATCCGTTTTGACCCACA|TCGCTAATGTAACCTGCGAAGCTTCGACAC
GCCAAGCGACGAGCCACTCACCTCTCTTCT|ACTAGATTGCGCGAGCCTCGGAACACAAAG
GCGTCAACACCCTCGCGAGACACCCTCGCG|TACACCCTCGCGAGCGCCAAGCGACGAGCC
GTAACCTGCGAAGCTTCGACACCCTCGCGA|TATGATGGCTTGATCTACCCTTTACTCCGT
CGAGCCTCGGAACACAAAGTGCCTGAAAGC|AGTAAACACCCTCGCGAGCGCCAAGCGACG
GTGCCAATGCAAAGAGGAGTGTGCTCCGGC|CATCGCTTCGACCGGTCGTCTAATGCCGGG
AGTTCTGATCGACACCCTCGCGAGCGCCAA|CGATTCACTGCATGAGCCCACGCATACTGG
ATACACCCTCGCGAGCGCCAAGCGACGAGC|CGCCCACCGATGTCGGCCACTGCGTAGCTA
GTACCTGAGGTGGGTCACCTCCGTAGGTTC|GGACCCAGCTCCGAACATGAATACACCTAG
CCCTCGCGAGCACACCCTCGCGAGCGCCAA|CTCTTCTCTTGGGTGCTGGTTCGAAGCCCA
GAGCCACTCACCTCTCTTCTCTTGGGTGCT|GCGAGCCTCGGAACACAAAGTGCCTGAAAG
CCTCGCGAGCGCCAAGCGACGAGCCATGCT|CTCGCGAGCGCCAAGCGACGAGCCACGTAA
CAGGGATTATTATGGCGTCGTGACCTCATG|GTGTGCTATCCGCCGGCCTCGCTAATGTAA
CGCGAGCGCCAAGCGACGAGCCACTACGCC|CACGCATACTGGCAGCAACACCCTCGCGAG
TGCCTGCAGGGCCAACTCACGGACGCCCAC|GTGTGTGGTCGCGATGAGTGCCAATGCAAA
TTCTCTTGGGTGCTGGTTCGAAGCCCAAAC|AAAGTGCCTGAAAGCAGACGTAAAACCCGA
GGTATGGTAACACCCTCGCGAGCGCCAAGC|GGCAAATCGACACCCTCGCGAGCGCCAAGC
ACCCTCGCGAGCGCCAAGCGACGAGCCACG|CACCGATGTCGGCCACTGCGTAGCTAGGGA
AGGGATTATTATGGCGTCGTGACCTCATGA|TGTGCTATCCGCCGGCCTCGCTAATGTAAC
CGCCGGCCTCGCTAATGTAACCTGCGAAGC|ATAACTCGACAACTTTTATGATGGCTTGAT
CATGAATACACCTAGCTCGGTTTCTGCAAA|CCAAGCGACGAGCCAGCCAAGCGACGAGCC
AGCCAGATGTGGATTCACGCAGTAAACACC|ACCTCATGAATCCGTTTTGACCCACACCCT
GCGGATTGCCGGGCGACAATGGGTTTGGAG|AACCCCTCGATAACTTAATACTCTATTGAA
ATGGTAACACCCTCGCGAGCGCCAAGCGAC|AAATCGACACCCTCGCGAGCGCCAAGCGAC
GCGACAATGGGTTTGGAGTAGAAGGTATCA|ACTTAATACTCTATTGAACCAGGACACCAT
CCAAGCGACGAGCCAGACTTACTCGGGTAT|AAGCGACGAGCCATGCTTCCTGCCTGGCAA
GCGACGAGCCACTACGCCCACGGCAGTTGG|CAGCAACACCCTCGCGAGCGCCAAGCGACG
TCGCGAGCGCCAAGCGACGAGCCATGCTTC|CGCGAGCGCCAAGCGACGAGCCACGTAATA
TACACGATGAGTAGTAGGGAAACTATTTTT|GGAGTAGAAGGTATCATGCTCAGGGTGATA
ACCCTCGCGAGCGCCAAGCGACGAGCCAGA|ACCCTCGCGAGCGCCAAGCGACGAGCCACT
GGCCAACTCACGGACGCCCACCGATGTCGG|CGCGATGAGTGCCAATGCAAAGAGGAGTGT
GCGTCGTGACCTCATGAATCCGTTTTGACC|GGCCTCGCTAATGTAACCTGCGAAGCTTCG
GAGCCAGATGTGGATTCACGCAGTAAACAC|GACCTCATGAATCCGTTTTGACCCACACCC
AGCCACATCACGGGGCGGAACGAGACTAGA|GAGCGCCAAGCGACGAGCCAGATGTGGATT
CCCTCGCGAGCGCCAAGCGACGAGCCACGC|GACGAGCCACATCACGGGGCGGAACGAGAC
TCACTGCATGAGCCCACGCATACTGGCAGC|ACACCCTCGCGAGACACCCTCGCGAGCGCC
CACGCATACTGGCAGCAACACCCTCGCGAG|CACCCTCGCGAGCGCCAAGCGACGAGCCAC
CTCGCGAGCGCCAAGCGACGAGCCAGATGT|GGGATTATTATGGCGTCGTGACCTCATGAA
CCGATGTCGGCCACTGCGTAGCTAGGGAAC|AGAGGAGTGTGCTCCGGCTGCCACTAGCGG
CTTCTCTTGGGTGCTGGTTCGAAGCCCAAA|CAAAGTGCCTGAAAGCAGACGTAAAACCCG
ATCCCTTAGCGTCTACACCCTCGCGAGCGC|GCGCCAAGCGACGAGCCAGGTCTGCTTACA
TGGGTGCTGGTTCGAAGCCCAAACGGATGT|CCTGAAAGCAGACGTAAAACCCGACACCCT
TACACCCTCGCGAGCGCCAAGCGACGAGCC|AGCCAGGTCTGCTTACACACCCTCGCGAGC
CTCGGAACACAAAGTGCCTGAAAGCAGACG|ACACCCTCGCGAGCGCCAAGCGACGAGCCA
TTCTGATCGACACCCTCGCGAGCGCCAAGC|ATTCACTGCATGAGCCCACGCATACTGGCA
CGCGAGCGCCAAGCGACGAGCCAGACTTAC|CGAGCGCCAAGCGACGAGCCATGCTTCCTG
CGATGAGTGCCAATGCAAAGAGGAGTGTGC|ATACCCCATCGCTTCGACCGGTCGTCTAAT
CATTGAGTGTACCTGAGGTGGGTCACCTCC|GTAAGCAGGGACCCAGCTCCGAACATGAAT
GCGCCAAGCGACGAGCCAGCCAAGCGACGA|AAGCCCAAACGGATGTTATCGATCCCTTAG
ACGTAAAACCCGACACCCTCGCGAGCGCCA|CCAGACTTACTCGGGTATGGTAACACCCTC
GATTATTATGGCGTCGTGACCTCATGAATC|GCTATCCGCCGGCCTCGCTAATGTAACCTG
GACGAGCCATGCTTCCTGCCTGGCAAATCG|ACGAGCCACGTAATACACCCTCGCGAGCGC
CCTCGCGAGCGCCAAGCGACGAGCCACGGG|CCGATGTCGGCCACTGCGTAGCTAGGGAAC
ACCCTCGCGAGCGCCAAGCGACGAGCCATA|CGACGAGCCACGCCAAGCGACGAGCCACTC
TCCCATTGAGTGTACCTGAGGTGGGTCACC|CAAGTAAGCAGGGACCCAGCTCCGAACATG
CGGGTATGGTAACACCCTCGCGAGCGCCAA|CTGGCAAATCGACACCCTCGCGAGCGCCAA
ACGCCAAGCGACGAGCCACTCACCTCTCTT|AGACTAGATTGCGCGAGCCTCGGAACACAA
GCGACGAGCCACTCACCTCTCTTCTCTTGG|ATTGCGCGAGCCTCGGAACACAAAGTGCCT
ACACCCTCGCGAGCGCCAAGCGACGAGCCA|GGGTATGGTAACACCCTCGCGAGCGCCAAG
CACTCAGTGTGCTATCCGCCGGCCTCGCTA|GTTCTCCTAACTTTCCATAACTCGACAACT
CACTCACCTCTCTTCTCTTGGGTGCTGGTT|GCCTCGGAACACAAAGTGCCTGAAAGCAGA
TGCCGGGCGACAATGGGTTTGGAGTAGAAG|TCGATAACTTAATACTCTATTGAACCAGGA
GAGCCAGCGTCAACACCCTCGCGAGACACC|AGCGTCTACACCCTCGCGAGCGCCAAGCGA
AACACAAAGTGCCTGAAAGCAGACGTAAAA|CTCGCGAGCGCCAAGCGACGAGCCAGACTT
GGACCCAGCTCCGAACATGAATACACCTAG|ACACCCTCGCGAGCGCCAAGCGACGAGCCA
GCAAAGAGGAGTGTGCTCCGGCTGCCACTA|CGACCGGTCGTCTAATGCCGGGACCGTTGC
CTATTTTTAGTAGCGAATTTCACACCAGTG|GGGTGATAGCATCCGCTGTTGAGTGGGCGT
ATCCGTTTTGACCCACACCCTCGCGAGCGC|CTGCGAAGCTTCGACACCCTCGCGAGCGCC
CCAAGCGACGAGCCAGATGTGGATTCACGC|TGGCGTCGTGACCTCATGAATCCGTTTTGA
CCGCCGGCCTCGCTAATGTAACCTGCGAAG|CATAACTCGACAACTTTTATGATGGCTTGA
CCAAGCGACGAGCCACGTAATACACCCTCG|TGCAGGGCCAACTCACGGACGCCCACCGAT
CGCGAGCGCCAAGCGACGAGCCACGCCAAG|AGCCACATCACGGGGCGGAACGAGACTAGA
TGGGTTTGGAGTAGAAGGTATCATGCTCAG|ACTCTATTGAACCAGGACACCATAAATGTA
TACTCGGGTATGGTAACACCCTCGCGAGCG|CTGCCTGGCAAATCGACACCCTCGCGAGCG
TTTTAGTAGCGAATTTCACACCAGTGTGTG|GATAGCATCCGCTGTTGAGTGGGCGTGTCT
AGCTTCGACACCCTCGCGAGCGCCAAGCGA|GATCTACCCTTTACTCCGTGCCTGCAGGGC
CAAGCGACGAGCCACGGGTATCCATAAGGT|ACTGCGTAGCTAGGGAACTAGACCCAACAC
ACACCCTCGCGAGCGCCAAGCGACGAGCCA|ACCCTCGCGAGCGCCAAGCGACGAGCCATG
CGCGAGACACCCTCGCGAGCGCCAAGCGAC|GCGCCAAGCGACGAGCCACATCACGGGGCG
ACTGCATGAGCCCACGCATACTGGCAGCAA|ACCCTCGCGAGACACCCTCGCGAGCGCCAA
GCATGAGCCCACGCATACTGGCAGCAACAC|CTCGCGAGACACCCTCGCGAGCGCCAAGCG
CAACACACTAGTGCTATACACGATGAGTAG|GGGCGACAATGGGTTTGGAGTAGAAGGTAT
CCCTCGCGAGACACCCTCGCGAGCGCCAAG|GCGAGCGCCAAGCGACGAGCCACATCACGG
AGGTCTGCTTACACACCCTCGCGAGCGCCA|GCGACGAGCCAGAATCAGGGATTATTATGG
GAGCCACGTAATACACCCTCGCGAGCGCCA|AACTCACGGACGCCCACCGATGTCGGCCAC
AGACGTAAAACCCGACACCCTCGCGAGCGC|AGCCAGACTTACTCGGGTATGGTAACACCC
ACTCGACAACTTTTATGATGGCTTGATCTA|TGAGTAGTAGGGAAACTATTTTTAGTAGCG
CACGGGGCGGAACGAGACTAGATTGCGCGA|AGCGACGAGCCAGATGTGGATTCACGCAGT
CGCGAGCGCCAAGCGACGAGCCACGTAATA|TCCGTGCCTGCAGGGCCAACTCACGGACGC
GCTGCCACTAGCGGATTGCCGGGCGACAAT|GGACCGTTGCAACCCCTCGATAACTTAATA
CTCTTGGGTGCTGGTTCGAAGCCCAAACGG|AGTGCCTGAAAGCAGACGTAAAACCCGACA
AAGCAGACGTAAAACCCGACACCCTCGCGA|GACGAGCCAGACTTACTCGGGTATGGTAAC
AGATTGCGCGAGCCTCGGAACACAAAGTGC|ATTCACGCAGTAAACACCCTCGCGAGCGCC
CCCACCGATGTCGGCCACTGCGTAGCTAGG|GCAAAGAGGAGTGTGCTCCGGCTGCCACTA
AAGCGACGAGCCAGCGTCAACACCCTCGCG|ATCCCTTAGCGTCTACACCCTCGCGAGCGC
AACATGAATACACCTAGCTCGGTTTCTGCA|CGCCAAGCGACGAGCCAGCCAAGCGACGAG
GCCAAGCGACGAGCCAGGTCTGCTTACACA|CCTCGCGAGCGCCAAGCGACGAGCCAGAAT
GGAACGAGACTAGATTGCGCGAGCCTCGGA|GCCAGATGTGGATTCACGCAGTAAACACCC
GCCAAGCGACGAGCCAGCCAAGCGACGAGC|GCCCAAACGGATGTTATCGATCCCTTAGCG
GCCACTAGCGGATTGCCGGGCGACAATGGG|CCGTTGCAACCCCTCGATAACTTAATACTC
AAGGTATCATGCTCAGGGTGATAGCATCCG|GGACACCATAAATGTACCATTAGCATGTTA
GACGAGCCAGCCAAGCGACGAGCCAGCGTC|CGGATGTTATCGATCCCTTAGCGTCTACAC
GTGCTGGTTCGAAGCCCAAACGGATGTTAT|GAAAGCAGACGTAAAACCCGACACCCTCGC
GCTATCCGCCGGCCTCGCTAATGTAACCTG|CTTTCCATAACTCGACAACTTTTATGATGG
GAATCAGGGATTATTATGGCGTCGTGACCT|CTCAGTGTGCTATCCGCCGGCCTCGCTAAT
CTATCCGCCGGCCTCGCTAATGTAACCTGC|TTTCCATAACTCGACAACTTTTATGATGGC
GTTTCTCATCGTCAAGTAAGCAGGGACCCA|GAGCCATATACACCCTCGCGAGCACACCCT
GAGTAGAAGGTATCATGCTCAGGGTGATAG|GAACCAGGACACCATAAATGTACCATTAGC
TGTAACCTGCGAAGCTTCGACACCCTCGCG|TTATGATGGCTTGATCTACCCTTTACTCCG
GGTATCCATAAGGTTCTCCTAACTTTCCAT|ACTAGACCCAACACACTAGTGCTATACACG
CAGCTCCGAACATGAATACACCTAGCTCGG|CTCGCGAGCGCCAAGCGACGAGCCAGCCAA
CCACGCATACTGGCAGCAACACCCTCGCGA|ACACCCTCGCGAGCGCCAAGCGACGAGCCA
TGACCTCATGAATCCGTTTTGACCCACACC|GCTAATGTAACCTGCGAAGCTTCGACACCC
GCGACGAGCCACATCACGGGGCGGAACGAG|CCTCGCGAGCGCCAAGCGACGAGCCAGATG
CCACACCCTCGCGAGCGCCAAGCGACGAGC|GACACCCTCGCGAGCGCCAAGCGACGAGCC
TAAACACCCTCGCGAGCGCCAAGCGACGAG|CACACCCTCGCGAGCGCCAAGCGACGAGCC
AAGCTTCGACACCCTCGCGAGCGCCAAGCG|TGATCTACCCTTTACTCCGTGCCTGCAGGG
ATGAGTAGTAGGGAAACTATTTTTAGTAGC|GAAGGTATCATGCTCAGGGTGATAGCATCC
CTAGTTGCAGTCCCATTGAGTGTACCTGAG|TTCTCATCGTCAAGTAAGCAGGGACCCAGC
GGATTGCCGGGCGACAATGGGTTTGGAGTA|CCCCTCGATAACTTAATACTCTATTGAACC
TAGAAAGCAAAGTTCTGATCGACACCCTCG|CTGCAAATCTCGATTCACTGCATGAGCCCA
TGCAAATCTCGATTCACTGCATGAGCCCAC|CGAGCCAGCGTCAACACCCTCGCGAGACAC
CGACGAGCCACTCACCTCTCTTCTCTTGGG|TTGCGCGAGCCTCGGAACACAAAGTGCCTG
CAACTTTTATGATGGCTTGATCTACCCTTT|GTAGGGAAACTATTTTTAGTAGCGAATTTC
CAGTGTGTGGTCGCGATGAGTGCCAATGCA|GGCGTGTCTGCACATACCCCATCGCTTCGA
CTCCGGCTGCCACTAGCGGATTGCCGGGCG|TGCCGGGACCGTTGCAACCCCTCGATAACT
GAGCGCCAAGCGACGAGCCACATCACGGGG|CTTACACACCCTCGCGAGCGCCAAGCGACG
ACGAGCCATATACACCCTCGCGAGCACACC|CGAGCCACTCACCTCTCTTCTCTTGGGTGC
TCTCCTAACTTTCCATAACTCGACAACTTT|ACTAGTGCTATACACGATGAGTAGTAGGGA
ACACCCTCGCGAGCGCCAAGCGACGAGCCA|CAAGCGACGAGCCACGGGTATCCATAAGGT
GACGTAAAACCCGACACCCTCGCGAGCGCC|GCCAGACTTACTCGGGTATGGTAACACCCT
CTCGACAACTTTTATGATGGCTTGATCTAC|GAGTAGTAGGGAAACTATTTTTAGTAGCGA
CGCCAAGCGACGAGCCACTCACCTCTCTTC|GACTAGATTGCGCGAGCCTCGGAACACAAA
CTTTTATGATGGCTTGATCTACCCTTTACT|GGGAAACTATTTTTAGTAGCGAATTTCACA
CCAAGCGACGAGCCATATACACCCTCGCGA|CAAGCGACGAGCCACTCACCTCTCTTCTCT
CGACGAGCCAGCCAAGCGACGAGCCAGCGT|ACGGATGTTATCGATCCCTTAGCGTCTACA
GCCTCGGAACACAAAGTGCCTGAAAGCAGA|AAACACCCTCGCGAGCGCCAAGCGACGAGC
TCGATTCACTGCATGAGCCCACGCATACTG|CGTCAACACCCTCGCGAGACACCCTCGCGA
GCGACGAGCCAGATGTGGATTCACGCAGTA|GTCGTGACCTCATGAATCCGTTTTGACCCA
TACACCCTCGCGAGCACACCCTCGCGAGCG|ACCTCTCTTCTCTTGGGTGCTGGTTCGAAG
GACGAGCCAGCGTCAACACCCTCGCGAGAC|CTTAGCGTCTACACCCTCGCGAGCGCCAAG
TAACTCGACAACTTTTATGATGGCTTGATC|GATGAGTAGTAGGGAAACTATTTTTAGTAG
AAGTGCCTGAAAGCAGACGTAAAACCCGAC|AGCGCCAAGCGACGAGCCAGACTTACTCGG
GAGCGCCAAGCGACGAGCCACTCAGTGTGC|GCCACGGGTATCCATAAGGTTCTCCTAACT
GCGACGAGCCATGCTTCCTGCCTGGCAAAT|CGACGAGCCACGTAATACACCCTCGCGAGC
CGGCTGCCACTAGCGGATTGCCGGGCGACA|CGGGACCGTTGCAACCCCTCGATAACTTAA
TCGACACCCTCGCGAGCGCCAAGCGACGAG|CGCCAAGCGACGAGCCACGGGTATCCATAA
TCAAGTAAGCAGGGACCCAGCTCCGAACAT|ACCCTCGCGAGCACACCCTCGCGAGCGCCA
CGTCAAGTAAGCAGGGACCCAGCTCCGAAC|ACACCCTCGCGAGCACACCCTCGCGAGCGC
GAACACAAAGTGCCTGAAAGCAGACGTAAA|CCTCGCGAGCGCCAAGCGACGAGCCAGACT
AGCAGACGTAAAACCCGACACCCTCGCGAG|ACGAGCCAGACTTACTCGGGTATGGTAACA
GTCGTGACCTCATGAATCCGTTTTGACCCA|CCTCGCTAATGTAACCTGCGAAGCTTCGAC
TCGGTTTCTGCAAATCTCGATTCACTGCAT|CCAAGCGACGAGCCAGCGTCAACACCCTCG
AACACCCTCGCGAGCGCCAAGCGACGAGCC|CACCCTCGCGAGCGCCAAGCGACGAGCCAT
ACCCTCGCGAGCGCCAAGCGACGAGCCACG|CGACGAGCCACATCACGGGGCGGAACGAGA
TCGACACCCTCGCGAGCGCCAAGCGACGAG|TGCATGAGCCCACGCATACTGGCAGCAACA
TTGGTTTCTCATCGTCAAGTAAGCAGGGAC|GACGAGCCATATACACCCTCGCGAGCACAC
AAAGAGGAGTGTGCTCCGGCTGCCACTAGC|ACCGGTCGTCTAATGCCGGGACCGTTGCAA
TTGGAGTAGAAGGTATCATGCTCAGGGTGA|ATTGAACCAGGACACCATAAATGTACCATT
GGATTATTATGGCGTCGTGACCTCATGAAT|TGCTATCCGCCGGCCTCGCTAATGTAACCT
AGAGGAGTGTGCTCCGGCTGCCACTAGCGG|CGGTCGTCTAATGCCGGGACCGTTGCAACC
TCGCGAGCGCCAAGCGACGAGCCAGAATCA|TCGCGAGCGCCAAGCGACGAGCCACTCAGT
GCGCCAAGCGACGAGCCACATCACGGGGCG|TACACACCCTCGCGAGCGCCAAGCGACGAG
CAACACCCTCGCGAGCGCCAAGCGACGAGC|CAAGCGACGAGCCACGCCAAGCGACGAGCC
GCGAGCGCCAAGCGACGAGCCACGTAATAC|CCGTGCCTGCAGGGCCAACTCACGGACGCC
GTGCCTGCAGGGCCAACTCACGGACGCCCA|AGTGTGTGGTCGCGATGAGTGCCAATGCAA
TTAGTAGCGAATTTCACACCAGTGTGTGGT|TAGCATCCGCTGTTGAGTGGGCGTGTCTGC
TGCCTGAAAGCAGACGTAAAACCCGACACC|GCCAAGCGACGAGCCAGACTTACTCGGGTA
GTAGGGAAACTATTTTTAGTAGCGAATTTC|TCATGCTCAGGGTGATAGCATCCGCTGTTG
ACGCCCACGGCAGTTGGTTTCTCATCGTCA|GCGAGCGCCAAGCGACGAGCCATATACACC
GGTGGGTCACCTCCGTAGGTTCATGGCTAA|CTCCGAACATGAATACACCTAGCTCGGTTT
CAGGGCCAACTCACGGACGCCCACCGATGT|GGTCGCGATGAGTGCCAATGCAAAGAGGAG
CCTCGCGAGCGCCAAGCGACGAGCCACATC|GGTCTGCTTACACACCCTCGCGAGCGCCAA
AGATGTGGATTCACGCAGTAAACACCCTCG|CATGAATCCGTTTTGACCCACACCCTCGCG
CACAAAGTGCCTGAAAGCAGACGTAAAACC|CGCGAGCGCCAAGCGACGAGCCAGACTTAC
ACCCTCGCGAGCGCCAAGCGACGAGCCACG|TTTACTCCGTGCCTGCAGGGCCAACTCACG
TAGTAGCGAATTTCACACCAGTGTGTGGTC|AGCATCCGCTGTTGAGTGGGCGTGTCTGCA
TCGCGAGACACCCTCGCGAGCGCCAAGCGA|AGCGCCAAGCGACGAGCCACATCACGGGGC
CCATATACACCCTCGCGAGCACACCCTCGC|CACTCACCTCTCTTCTCTTGGGTGCTGGTT
GGGTTTGGAGTAGAAGGTATCATGCTCAGG|CTCTATTGAACCAGGACACCATAAATGTAC
CTTTACTCCGTGCCTGCAGGGCCAACTCAC|TTTCACACCAGTGTGTGGTCGCGATGAGTG
GAGCCTCGGAACACAAAGTGCCTGAAAGCA|GTAAACACCCTCGCGAGCGCCAAGCGACGA
GTGTGTGGTCGCGATGAGTGCCAATGCAAA|CGTGTCTGCACATACCCCATCGCTTCGACC
AGCAAAGTTCTGATCGACACCCTCGCGAGC|AATCTCGATTCACTGCATGAGCCCACGCAT
CCCTTAGCGTCTACACCCTCGCGAGCGCCA|GCCAAGCGACGAGCCAGGTCTGCTTACACA
AACACCCTCGCGAGACACCCTCGCGAGCGC|CCTCGCGAGCGCCAAGCGACGAGCCACATC
ACACACTAGTGCTATACACGATGAGTAGTA|GCGACAATGGGTTTGGAGTAGAAGGTATCA
ACCCTCGCGAGCGCCAAGCGACGAGCCAGA|CCTCGCGAGCGCCAAGCGACGAGCCATGCT
ATGAATCCGTTTTGACCCACACCCTCGCGA|TAACCTGCGAAGCTTCGACACCCTCGCGAG
GCGAGCGCCAAGCGACGAGCCACTCAGTGT|GAGCCACGGGTATCCATAAGGTTCTCCTAA
GAGTGTACCTGAGGTGGGTCACCTCCGTAG|GCAGGGACCCAGCTCCGAACATGAATACAC
ACGAGCCACGGGTATCCATAAGGTTCTCCT|TAGCTAGGGAACTAGACCCAACACACTAGT
CTTTCCATAACTCGACAACTTTTATGATGG|TATACACGATGAGTAGTAGGGAAACTATTT
CGACAACTTTTATGATGGCTTGATCTACCC|GTAGTAGGGAAACTATTTTTAGTAGCGAAT
CCCACGCATACTGGCAGCAACACCCTCGCG|GACACCCTCGCGAGCGCCAAGCGACGAGCC
CACCCTCGCGAGCGCCAAGCGACGAGCCAC|TGAGCCCACGCATACTGGCAGCAACACCCT
GCGACGAGCCACGCCAAGCGACGAGCCACT|GGGCGGAACGAGACTAGATTGCGCGAGCCT
TGAGCCCACGCATACTGGCAGCAACACCCT|GCGAGACACCCTCGCGAGCGCCAAGCGACG
AGGGAAACTATTTTTAGTAGCGAATTTCAC|ATGCTCAGGGTGATAGCATCCGCTGTTGAG
GACAACTTTTATGATGGCTTGATCTACCCT|TAGTAGGGAAACTATTTTTAGTAGCGAATT
GAGCGCCAAGCGACGAGCCACGTAATACAC|GTGCCTGCAGGGCCAACTCACGGACGCCCA
CGCCCACGGCAGTTGGTTTCTCATCGTCAA|CGAGCGCCAAGCGACGAGCCATATACACCC
AGACCCAACACACTAGTGCTATACACGATG|TTGCCGGGCGACAATGGGTTTGGAGTAGAA
ATGAGTGCCAATGCAAAGAGGAGTGTGCTC|ACCCCATCGCTTCGACCGGTCGTCTAATGC
CCTGAAAGCAGACGTAAAACCCGACACCCT|CAAGCGACGAGCCAGACTTACTCGGGTATG
GCGAGCGCCAAGCGACGAGCCAGACTTACT|GAGCGCCAAGCGACGAGCCATGCTTCCTGC
ATCTCGATTCACTGCATGAGCCCACGCATA|CAGCGTCAACACCCTCGCGAGACACCCTCG
CATCGTCAAGTAAGCAGGGACCCAGCTCCG|TATACACCCTCGCGAGCACACCCTCGCGAG
ATCTACCCTTTACTCCGTGCCTGCAGGGCC|TAGCGAATTTCACACCAGTGTGTGGTCGCG
AAGCAGGGACCCAGCTCCGAACATGAATAC|GCGAGCACACCCTCGCGAGCGCCAAGCGAC
CCACTCACCTCTCTTCTCTTGGGTGCTGGT|AGCCTCGGAACACAAAGTGCCTGAAAGCAG
ACCCTCGCGAGCGCCAAGCGACGAGCCACT|AGCGACGAGCCACGGGTATCCATAAGGTTC
TCGCGAGCGCCAAGCGACGAGCCATATACA|GAGCCACGCCAAGCGACGAGCCACTCACCT
AACACCCTCGCGAGCGCCAAGCGACGAGCC|GACACCCTCGCGAGCGCCAAGCGACGAGCC
GCGAGCGCCAAGCGACGAGCCACGGGTATC|TGTCGGCCACTGCGTAGCTAGGGAACTAGA
AGTGCTATACACGATGAGTAGTAGGGAAAC|TGGGTTTGGAGTAGAAGGTATCATGCTCAG
GCACACCCTCGCGAGCGCCAAGCGACGAGC|TGGGTGCTGGTTCGAAGCCCAAACGGATGT
GCCTGGCAAATCGACACCCTCGCGAGCGCC|CCCTCGCGAGCGCCAAGCGACGAGCCACGG
AGTTGGTTTCTCATCGTCAAGTAAGCAGGG|GCGACGAGCCATATACACCCTCGCGAGCAC
AAGCGACGAGCCACGGGTATCCATAAGGTT|CTGCGTAGCTAGGGAACTAGACCCAACACA
GTTCGAAGCCCAAACGGATGTTATCGATCC|AGACGTAAAACCCGACACCCTCGCGAGCGC
ATACTGGCAGCAACACCCTCGCGAGCGCCA|TCGCGAGCGCCAAGCGACGAGCCACGCCAA
CGCCAAGCGACGAGCCACGGGTATCCATAA|GCCACTGCGTAGCTAGGGAACTAGACCCAA
GCCAGCCAAGCGACGAGCCAGCGTCAACAC|GTTATCGATCCCTTAGCGTCTACACCCTCG
GTCTGCTTACACACCCTCGCGAGCGCCAAG|GACGAGCCAGAATCAGGGATTATTATGGCG
TTCTTTCTAGTTGCAGTCCCATTGAGTGTA|GTTGGTTTCTCATCGTCAAGTAAGCAGGGA
ACTCCGTGCCTGCAGGGCCAACTCACGGAC|ACACCAGTGTGTGGTCGCGATGAGTGCCAA
AATGCAAAGAGGAGTGTGCTCCGGCTGCCA|CTTCGACCGGTCGTCTAATGCCGGGACCGT
CGACGAGCCATATACACCCTCGCGAGCACA|GACGAGCCACTCACCTCTCTTCTCTTGGGT
ACCAGTGTGTGGTCGCGATGAGTGCCAATG|TGGGCGTGTCTGCACATACCCCATCGCTTC
AGCTAGGGAACTAGACCCAACACACTAGTG|GCCACTAGCGGATTGCCGGGCGACAATGGG
GCGAGCGCCAAGCGACGAGCCAGAATCAGG|GCGAGCGCCAAGCGACGAGCCACTCAGTGT
GAGCGCCAAGCGACGAGCCACGCCAAGCGA|CACATCACGGGGCGGAACGAGACTAGATTG
GAGCCACGGGTATCCATAAGGTTCTCCTAA|GCTAGGGAACTAGACCCAACACACTAGTGC
ACCCTTTACTCCGTGCCTGCAGGGCCAACT|GAATTTCACACCAGTGTGTGGTCGCGATGA
ATGGCGTCGTGACCTCATGAATCCGTTTTG|GCCGGCCTCGCTAATGTAACCTGCGAAGCT
AATACACCCTCGCGAGCGCCAAGCGACGAG|ACGCCCACCGATGTCGGCCACTGCGTAGCT
AAAGCAAAGTTCTGATCGACACCCTCGCGA|CAAATCTCGATTCACTGCATGAGCCCACGC
TGGAGTAGAAGGTATCATGCTCAGGGTGAT|TTGAACCAGGACACCATAAATGTACCATTA
AACACCCTCGCGAGCGCCAAGCGACGAGCC|AAGCGACGAGCCACGCCAAGCGACGAGCCA
GAGACACCCTCGCGAGCGCCAAGCGACGAG|CCAAGCGACGAGCCACATCACGGGGCGGAA
TAGTGCTATACACGATGAGTAGTAGGGAAA|ATGGGTTTGGAGTAGAAGGTATCATGCTCA
CGACGAGCCAGACTTACTCGGGTATGGTAA|ACGAGCCATGCTTCCTGCCTGGCAAATCGA
AACTTTTATGATGGCTTGATCTACCCTTTA|TAGGGAAACTATTTTTAGTAGCGAATTTCA
CGCTAATGTAACCTGCGAAGCTTCGACACC|CAACTTTTATGATGGCTTGATCTACCCTTT
GTGCTATACACGATGAGTAGTAGGGAAACT|GGGTTTGGAGTAGAAGGTATCATGCTCAGG
CGCGAGCGCCAAGCGACGAGCCAGAATCAG|CGCGAGCGCCAAGCGACGAGCCACTCAGTG
TGGCAGCAACACCCTCGCGAGCGCCAAGCG|GAGCGCCAAGCGACGAGCCACGCCAAGCGA
ACTAGATTGCGCGAGCCTCGGAACACAAAG|TGGATTCACGCAGTAAACACCCTCGCGAGC
TTGCGCGAGCCTCGGAACACAAAGTGCCTG|CACGCAGTAAACACCCTCGCGAGCGCCAAG
AGCGTCAACACCCTCGCGAGACACCCTCGC|CTACACCCTCGCGAGCGCCAAGCGACGAGC
ATAACTCGACAACTTTTATGATGGCTTGAT|CGATGAGTAGTAGGGAAACTATTTTTAGTA
GGGCGACAATGGGTTTGGAGTAGAAGGTAT|TAACTTAATACTCTATTGAACCAGGACACC
GCGAGCGCCAAGCGACGAGCCACTACGCCC|ACGCATACTGGCAGCAACACCCTCGCGAGC
ATTATGGCGTCGTGACCTCATGAATCCGTT|TCCGCCGGCCTCGCTAATGTAACCTGCGAA
CCTAACTTTCCATAACTCGACAACTTTTAT|AGTGCTATACACGATGAGTAGTAGGGAAAC
ACGATGAGTAGTAGGGAAACTATTTTTAGT|GTAGAAGGTATCATGCTCAGGGTGATAGCA
GCCTGAAAGCAGACGTAAAACCCGACACCC|CCAAGCGACGAGCCAGACTTACTCGGGTAT
ACAAAGTGCCTGAAAGCAGACGTAAAACCC|GCGAGCGCCAAGCGACGAGCCAGACTTACT
GAAGCCCAAACGGATGTTATCGATCCCTTA|GTAAAACCCGACACCCTCGCGAGCGCCAAG
TGAGTAGTAGGGAAACTATTTTTAGTAGCG|AAGGTATCATGCTCAGGGTGATAGCATCCG
GAGCGCCAAGCGACGAGCCATGCTTCCTGC|AGCGCCAAGCGACGAGCCACGTAATACACC
TAGATTGCGCGAGCCTCGGAACACAAAGTG|GATTCACGCAGTAAACACCCTCGCGAGCGC
GCTCCGAACATGAATACACCTAGCTCGGTT|CGCGAGCGCCAAGCGACGAGCCAGCCAAGC
GGGATTATTATGGCGTCGTGACCTCATGAA|GTGCTATCCGCCGGCCTCGCTAATGTAACC
GGGTATGGTAACACCCTCGCGAGCGCCAAG|TGGCAAATCGACACCCTCGCGAGCGCCAAG
ACCCTCGCGAGCACACCCTCGCGAGCGCCA|TCTCTTCTCTTGGGTGCTGGTTCGAAGCCC
TTTGGAGTAGAAGGTATCATGCTCAGGGTG|TATTGAACCAGGACACCATAAATGTACCAT
GCCTGCAGGGCCAACTCACGGACGCCCACC|TGTGTGGTCGCGATGAGTGCCAATGCAAAG
TTACTCGGGTATGGTAACACCCTCGCGAGC|CCTGCCTGGCAAATCGACACCCTCGCGAGC
TGCGAAGCTTCGACACCCTCGCGAGCGCCA|GGCTTGATCTACCCTTTACTCCGTGCCTGC
TAACACCCTCGCGAGCGCCAAGCGACGAGC|CGACACCCTCGCGAGCGCCAAGCGACGAGC
TTCACTGCATGAGCCCACGCATACTGGCAG|AACACCCTCGCGAGACACCCTCGCGAGCGC
TACACCTAGCTCGGTTTCTGCAAATCTCGA|GACGAGCCAGCCAAGCGACGAGCCAGCGTC
GCTAATAGAAAGCAAAGTTCTGATCGACAC|GGTTTCTGCAAATCTCGATTCACTGCATGA
TTCCTGCCTGGCAAATCGACACCCTCGCGA|ATACACCCTCGCGAGCGCCAAGCGACGAGC
CTCGCGAGACACCCTCGCGAGCGCCAAGCG|GAGCGCCAAGCGACGAGCCACATCACGGGG
GTTTTGACCCACACCCTCGCGAGCGCCAAG|GAAGCTTCGACACCCTCGCGAGCGCCAAGC
TCGGAACACAAAGTGCCTGAAAGCAGACGT|CACCCTCGCGAGCGCCAAGCGACGAGCCAG
TTCTCCTAACTTTCCATAACTCGACAACTT|CACTAGTGCTATACACGATGAGTAGTAGGG
TTATGGCGTCGTGACCTCATGAATCCGTTT|CCGCCGGCCTCGCTAATGTAACCTGCGAAG
TTCGACACCCTCGCGAGCGCCAAGCGACGA|CTACCCTTTACTCCGTGCCTGCAGGGCCAA
CGCGAGCCTCGGAACACAAAGTGCCTGAAA|GCAGTAAACACCCTCGCGAGCGCCAAGCGA
TGCAAAGAGGAGTGTGCTCCGGCTGCCACT|TCGACCGGTCGTCTAATGCCGGGACCGTTG
AAATCTCGATTCACTGCATGAGCCCACGCA|GCCAGCGTCAACACCCTCGCGAGACACCCT
GAGCACACCCTCGCGAGCGCCAAGCGACGA|CTTGGGTGCTGGTTCGAAGCCCAAACGGAT
ACACCCTCGCGAGCGCCAAGCGACGAGCCA|GGTGCTGGTTCGAAGCCCAAACGGATGTTA
CAAGCGACGAGCCATATACACCCTCGCGAG|AAGCGACGAGCCACTCACCTCTCTTCTCTT
AACTCACGGACGCCCACCGATGTCGGCCAC|ATGAGTGCCAATGCAAAGAGGAGTGTGCTC
AGCCCACGCATACTGGCAGCAACACCCTCG|GAGACACCCTCGCGAGCGCCAAGCGACGAG
CGACAATGGGTTTGGAGTAGAAGGTATCAT|CTTAATACTCTATTGAACCAGGACACCATA
CGATCCCTTAGCGTCTACACCCTCGCGAGC|GAGCGCCAAGCGACGAGCCAGGTCTGCTTA
CGCCAAGCGACGAGCCACTCAGTGTGCTAT|ACGGGTATCCATAAGGTTCTCCTAACTTTC
CTTCGACACCCTCGCGAGCGCCAAGCGACG|TCTACCCTTTACTCCGTGCCTGCAGGGCCA
AGCTCGGTTTCTGCAAATCTCGATTCACTG|CAGCCAAGCGACGAGCCAGCGTCAACACCC
CAGGGACCCAGCTCCGAACATGAATACACC|AGCACACCCTCGCGAGCGCCAAGCGACGAG
AGCCAGAATCAGGGATTATTATGGCGTCGT|AGCCACTCAGTGTGCTATCCGCCGGCCTCG
CCTCGCGAGACACCCTCGCGAGCGCCAAGC|CGAGCGCCAAGCGACGAGCCACATCACGGG
CGTCAACACCCTCGCGAGACACCCTCGCGA|ACACCCTCGCGAGCGCCAAGCGACGAGCCA
CTTACTCGGGTATGGTAACACCCTCGCGAG|TCCTGCCTGGCAAATCGACACCCTCGCGAG
CCAAGCGACGAGCCACATCACGGGGCGGAA|ACACCCTCGCGAGCGCCAAGCGACGAGCCA
TAATACACCCTCGCGAGCGCCAAGCGACGA|GACGCCCACCGATGTCGGCCACTGCGTAGC
CCATAACTCGACAACTTTTATGATGGCTTG|CACGATGAGTAGTAGGGAAACTATTTTTAG
CGCATACTGGCAGCAACACCCTCGCGAGCG|CCCTCGCGAGCGCCAAGCGACGAGCCACGC
AACACACTAGTGCTATACACGATGAGTAGT|GGCGACAATGGGTTTGGAGTAGAAGGTATC
GCCAAGCGACGAGCCACGCCAAGCGACGAG|TCACGGGGCGGAACGAGACTAGATTGCGCG
TTCTCATCGTCAAGTAAGCAGGGACCCAGC|GCCATATACACCCTCGCGAGCACACCCTCG
CATGAGCCCACGCATACTGGCAGCAACACC|TCGCGAGACACCCTCGCGAGCGCCAAGCGA
GTTCTTCTTTCTAGTTGCAGTCCCATTGAG|GGCAGTTGGTTTCTCATCGTCAAGTAAGCA
CGAGCACACCCTCGCGAGCGCCAAGCGACG|TCTTGGGTGCTGGTTCGAAGCCCAAACGGA
CCAGCCAAGCGACGAGCCAGCGTCAACACC|TTATCGATCCCTTAGCGTCTACACCCTCGC
CACTAGCGGATTGCCGGGCGACAATGGGTT|GTTGCAACCCCTCGATAACTTAATACTCTA
CAAGCGACGAGCCACTCAGTGTGCTATCCG|GGTATCCATAAGGTTCTCCTAACTTTCCAT
TCCGTGCCTGCAGGGCCAACTCACGGACGC|ACCAGTGTGTGGTCGCGATGAGTGCCAATG
CGACGAGCCAGGTCTGCTTACACACCCTCG|GAGCGCCAAGCGACGAGCCAGAATCAGGGA
CTCGCGAGCGCCAAGCGACGAGCCACATCA|GTCTGCTTACACACCCTCGCGAGCGCCAAG
AGTGTGCTATCCGCCGGCCTCGCTAATGTA|CCTAACTTTCCATAACTCGACAACTTTTAT
AGCGCCAAGCGACGAGCCACATCACGGGGC|TTACACACCCTCGCGAGCGCCAAGCGACGA
AACGGATGTTATCGATCCCTTAGCGTCTAC|CGACACCCTCGCGAGCGCCAAGCGACGAGC
ACACCCTCGCGAGACACCCTCGCGAGCGCC|CTCGCGAGCGCCAAGCGACGAGCCACATCA
CCTCGCTAATGTAACCTGCGAAGCTTCGAC|CGACAACTTTTATGATGGCTTGATCTACCC
GCAGTCCCATTGAGTGTACCTGAGGTGGGT|TCGTCAAGTAAGCAGGGACCCAGCTCCGAA
CACTAGTGCTATACACGATGAGTAGTAGGG|ACAATGGGTTTGGAGTAGAAGGTATCATGC
CCTGCCTGGCAAATCGACACCCTCGCGAGC|ACACCCTCGCGAGCGCCAAGCGACGAGCCA
TTCTAGTTGCAGTCCCATTGAGTGTACCTG|GTTTCTCATCGTCAAGTAAGCAGGGACCCA
CCAGATGTGGATTCACGCAGTAAACACCCT|CTCATGAATCCGTTTTGACCCACACCCTCG
GCCATATACACCCTCGCGAGCACACCCTCG|CCACTCACCTCTCTTCTCTTGGGTGCTGGT
ACGGACGCCCACCGATGTCGGCCACTGCGT|TGCCAATGCAAAGAGGAGTGTGCTCCGGCT
AACTCGACAACTTTTATGATGGCTTGATCT|ATGAGTAGTAGGGAAACTATTTTTAGTAGC
ACCTCATGAATCCGTTTTGACCCACACCCT|TAATGTAACCTGCGAAGCTTCGACACCCTC
CGCGAGCGCCAAGCGACGAGCCAGCCAAGC|GTTCGAAGCCCAAACGGATGTTATCGATCC
CGCCAAGCGACGAGCCAGCCAAGCGACGAG|AGCCCAAACGGATGTTATCGATCCCTTAGC
GTGGATTCACGCAGTAAACACCCTCGCGAG|AATCCGTTTTGACCCACACCCTCGCGAGCG
TGGCTTGATCTACCCTTTACTCCGTGCCTG|TTTTTAGTAGCGAATTTCACACCAGTGTGT
GACGAGCCACTCAGTGTGCTATCCGCCGGC|CCATAAGGTTCTCCTAACTTTCCATAACTC
TCTACCCTTTACTCCGTGCCTGCAGGGCCA|AGCGAATTTCACACCAGTGTGTGGTCGCGA
GAAACTATTTTTAGTAGCGAATTTCACACC|CTCAGGGTGATAGCATCCGCTGTTGAGTGG
CACCTAGCTCGGTTTCTGCAAATCTCGATT|CGAGCCAGCCAAGCGACGAGCCAGCGTCAA
GCAGTTGGTTTCTCATCGTCAAGTAAGCAG|AAGCGACGAGCCATATACACCCTCGCGAGC
ACACCCTCGCGAGCGCCAAGCGACGAGCCA|GCCAGGTCTGCTTACACACCCTCGCGAGCG
GAAAGCAAAGTTCTGATCGACACCCTCGCG|GCAAATCTCGATTCACTGCATGAGCCCACG
GCGAGCGCCAAGCGACGAGCCAGCCAAGCG|TTCGAAGCCCAAACGGATGTTATCGATCCC
CCTCCGTAGGTTCATGGCTAATAGAAAGCA|TGAATACACCTAGCTCGGTTTCTGCAAATC
TGTACCTGAGGTGGGTCACCTCCGTAGGTT|GGGACCCAGCTCCGAACATGAATACACCTA
CTCTTCTCTTGGGTGCTGGTTCGAAGCCCA|CACAAAGTGCCTGAAAGCAGACGTAAAACC
CTCGATTCACTGCATGAGCCCACGCATACT|GCGTCAACACCCTCGCGAGACACCCTCGCG
GAAGCTTCGACACCCTCGCGAGCGCCAAGC|TTGATCTACCCTTTACTCCGTGCCTGCAGG
GGTTTCTGCAAATCTCGATTCACTGCATGA|AAGCGACGAGCCAGCGTCAACACCCTCGCG
CGACACCCTCGCGAGCGCCAAGCGACGAGC|ACCCTTTACTCCGTGCCTGCAGGGCCAACT
CTCGCGAGCGCCAAGCGACGAGCCAGACTT|CGCGAGCGCCAAGCGACGAGCCATGCTTCC
CGACGAGCCATGCTTCCTGCCTGGCAAATC|GACGAGCCACGTAATACACCCTCGCGAGCG
GCCAAGCGACGAGCCACGTAATACACCCTC|CTGCAGGGCCAACTCACGGACGCCCACCGA
ACGCCCACCGATGTCGGCCACTGCGTAGCT|AATGCAAAGAGGAGTGTGCTCCGGCTGCCA
CTCTCTTCTCTTGGGTGCTGGTTCGAAGCC|AACACAAAGTGCCTGAAAGCAGACGTAAAA
ACGAGCCAGATGTGGATTCACGCAGTAAAC|GTGACCTCATGAATCCGTTTTGACCCACAC
TCTCGATTCACTGCATGAGCCCACGCATAC|AGCGTCAACACCCTCGCGAGACACCCTCGC
AGTTCTTCTTTCTAGTTGCAGTCCCATTGA|CGGCAGTTGGTTTCTCATCGTCAAGTAAGC
CCACGGGTATCCATAAGGTTCTCCTAACTT|AGGGAACTAGACCCAACACACTAGTGCTAT
GCCAAGCGACGAGCCAGCGTCAACACCCTC|TCGATCCCTTAGCGTCTACACCCTCGCGAG
TTTACTCCGTGCCTGCAGGGCCAACTCACG|TTCACACCAGTGTGTGGTCGCGATGAGTGC
ATATACACCCTCGCGAGCACACCCTCGCGA|CTCACCTCTCTTCTCTTGGGTGCTGGTTCG
GCGACGAGCCACGGGTATCCATAAGGTTCT|GCGTAGCTAGGGAACTAGACCCAACACACT
ACGAGACTAGATTGCGCGAGCCTCGGAACA|AGATGTGGATTCACGCAGTAAACACCCTCG
GTTGGTTTCTCATCGTCAAGTAAGCAGGGA|CGACGAGCCATATACACCCTCGCGAGCACA
ACCCAACACACTAGTGCTATACACGATGAG|GCCGGGCGACAATGGGTTTGGAGTAGAAGG
GCTTACACACCCTCGCGAGCGCCAAGCGAC|AGCCAGAATCAGGGATTATTATGGCGTCGT
GCGAGCGCCAAGCGACGAGCCATATACACC|GCCACGCCAAGCGACGAGCCACTCACCTCT
CGAGCCACTCACCTCTCTTCTCTTGGGTGC|CGCGAGCCTCGGAACACAAAGTGCCTGAAA
GAGGAGTGTGCTCCGGCTGCCACTAGCGGA|GGTCGTCTAATGCCGGGACCGTTGCAACCC
GTAGCGAATTTCACACCAGTGTGTGGTCGC|CATCCGCTGTTGAGTGGGCGTGTCTGCACA
TCGCTAATGTAACCTGCGAAGCTTCGACAC|ACAACTTTTATGATGGCTTGATCTACCCTT
TGTGGTCGCGATGAGTGCCAATGCAAAGAG|GTCTGCACATACCCCATCGCTTCGACCGGT
GCCAAGCGACGAGCCAGATGTGGATTCACG|ATGGCGTCGTGACCTCATGAATCCGTTTTG
GCAGGGACCCAGCTCCGAACATGAATACAC|GAGCACACCCTCGCGAGCGCCAAGCGACGA
GCGAATTTCACACCAGTGTGTGGTCGCGAT|CCGCTGTTGAGTGGGCGTGTCTGCACATAC
GACACCCTCGCGAGCGCCAAGCGACGAGCC|CGGGTATGGTAACACCCTCGCGAGCGCCAA
TAGACCCAACACACTAGTGCTATACACGAT|ATTGCCGGGCGACAATGGGTTTGGAGTAGA
GAGGTGGGTCACCTCCGTAGGTTCATGGCT|AGCTCCGAACATGAATACACCTAGCTCGGT
TCATGAATCCGTTTTGACCCACACCCTCGC|TGTAACCTGCGAAGCTTCGACACCCTCGCG
GACGAGCCACTCACCTCTCTTCTCTTGGGT|TGCGCGAGCCTCGGAACACAAAGTGCCTGA
CAGACGTAAAACCCGACACCCTCGCGAGCG|GAGCCAGACTTACTCGGGTATGGTAACACC
TCGCGAGCGCCAAGCGACGAGCCAGGTCTG|GGTAACACCCTCGCGAGCGCCAAGCGACGA
ACCCTCGCGAGCGCCAAGCGACGAGCCAGC|TGCTGGTTCGAAGCCCAAACGGATGTTATC
CTCACCTCTCTTCTCTTGGGTGCTGGTTCG|CTCGGAACACAAAGTGCCTGAAAGCAGACG
GGCTTGATCTACCCTTTACTCCGTGCCTGC|TTTTAGTAGCGAATTTCACACCAGTGTGTG
CTCCGAACATGAATACACCTAGCTCGGTTT|GCGAGCGCCAAGCGACGAGCCAGCCAAGCG
ATTCACTGCATGAGCCCACGCATACTGGCA|CAACACCCTCGCGAGACACCCTCGCGAGCG
AGCCAGGTCTGCTTACACACCCTCGCGAGC|CCAAGCGACGAGCCAGAATCAGGGATTATT
GCAGACGTAAAACCCGACACCCTCGCGAGC|CGAGCCAGACTTACTCGGGTATGGTAACAC
AGCCAGCGTCAACACCCTCGCGAGACACCC|GCGTCTACACCCTCGCGAGCGCCAAGCGAC
AGCGCCAAGCGACGAGCCACGTAATACACC|TGCCTGCAGGGCCAACTCACGGACGCCCAC
GAGCGCCAAGCGACGAGCCAGATGTGGATT|TATTATGGCGTCGTGACCTCATGAATCCGT
CCGTAGGTTCATGGCTAATAGAAAGCAAAG|ATACACCTAGCTCGGTTTCTGCAAATCTCG
GTGCTCCGGCTGCCACTAGCGGATTGCCGG|TAATGCCGGGACCGTTGCAACCCCTCGATA
CTCATGAATCCGTTTTGACCCACACCCTCG|ATGTAACCTGCGAAGCTTCGACACCCTCGC
CGAGCCACGGGTATCCATAAGGTTCTCCTA|AGCTAGGGAACTAGACCCAACACACTAGTG
CGGCCACTGCGTAGCTAGGGAACTAGACCC|TGTGCTCCGGCTGCCACTAGCGGATTGCCG
GACGAGCCAGAATCAGGGATTATTATGGCG|GACGAGCCACTCAGTGTGCTATCCGCCGGC
CGAGCCATGCTTCCTGCCTGGCAAATCGAC|GAGCCACGTAATACACCCTCGCGAGCGCCA
TATCGATCCCTTAGCGTCTACACCCTCGCG|CGCGAGCGCCAAGCGACGAGCCAGGTCTGC
CCAGACTTACTCGGGTATGGTAACACCCTC|ATGCTTCCTGCCTGGCAAATCGACACCCTC
GCCACGGGTATCCATAAGGTTCTCCTAACT|TAGGGAACTAGACCCAACACACTAGTGCTA
CCAAGCGACGAGCCACTCAGTGTGCTATCC|GGGTATCCATAAGGTTCTCCTAACTTTCCA
CGCGAGCGCCAAGCGACGAGCCATGCTTCC|GCGAGCGCCAAGCGACGAGCCACGTAATAC
CGAGCGCCAAGCGACGAGCCAGAATCAGGG|CGAGCGCCAAGCGACGAGCCACTCAGTGTG
TTTATGATGGCTTGATCTACCCTTTACTCC|GAAACTATTTTTAGTAGCGAATTTCACACC
ACCCTCGCGAGCGCCAAGCGACGAGCCAGA|TCAGGGATTATTATGGCGTCGTGACCTCAT
TTCGAAGCCCAAACGGATGTTATCGATCCC|GACGTAAAACCCGACACCCTCGCGAGCGCC
CTTCTTTCTAGTTGCAGTCCCATTGAGTGT|AGTTGGTTTCTCATCGTCAAGTAAGCAGGG
TTAGCGTCTACACCCTCGCGAGCGCCAAGC|AAGCGACGAGCCAGGTCTGCTTACACACCC
CCTCGCGAGCGCCAAGCGACGAGCCACTCA|CGACGAGCCACGGGTATCCATAAGGTTCTC
CTAGATTGCGCGAGCCTCGGAACACAAAGT|GGATTCACGCAGTAAACACCCTCGCGAGCG
TTTTTAGTAGCGAATTTCACACCAGTGTGT|TGATAGCATCCGCTGTTGAGTGGGCGTGTC
GTCAACACCCTCGCGAGACACCCTCGCGAG|CACCCTCGCGAGCGCCAAGCGACGAGCCAC
AGCCACGCCAAGCGACGAGCCACTCACCTC|AACGAGACTAGATTGCGCGAGCCTCGGAAC
GGTTTGGAGTAGAAGGTATCATGCTCAGGG|TCTATTGAACCAGGACACCATAAATGTACC
ATCGATCCCTTAGCGTCTACACCCTCGCGA|GCGAGCGCCAAGCGACGAGCCAGGTCTGCT
GCGACGAGCCAGAATCAGGGATTATTATGG|GCGACGAGCCACTCAGTGTGCTATCCGCCG
CCGTGCCTGCAGGGCCAACTCACGGACGCC|CCAGTGTGTGGTCGCGATGAGTGCCAATGC
CCCTCGCGAGCGCCAAGCGACGAGCCAGGT|TATGGTAACACCCTCGCGAGCGCCAAGCGA
AAGCGACGAGCCACTACGCCCACGGCAGTT|GGCAGCAACACCCTCGCGAGCGCCAAGCGA
CACATCACGGGGCGGAACGAGACTAGATTG|CGCCAAGCGACGAGCCAGATGTGGATTCAC
CCTGGCAAATCGACACCCTCGCGAGCGCCA|CCTCGCGAGCGCCAAGCGACGAGCCACGGG
CAACACCCTCGCGAGACACCCTCGCGAGCG|CCCTCGCGAGCGCCAAGCGACGAGCCACAT
TGCCAATGCAAAGAGGAGTGTGCTCCGGCT|ATCGCTTCGACCGGTCGTCTAATGCCGGGA
TCACGGGGCGGAACGAGACTAGATTGCGCG|AAGCGACGAGCCAGATGTGGATTCACGCAG
GGAAACTATTTTTAGTAGCGAATTTCACAC|GCTCAGGGTGATAGCATCCGCTGTTGAGTG
TACGCCCACGGCAGTTGGTTTCTCATCGTC|CGCGAGCGCCAAGCGACGAGCCATATACAC
CAAGCGACGAGCCAGCGTCAACACCCTCGC|GATCCCTTAGCGTCTACACCCTCGCGAGCG
AGTTGCAGTCCCATTGAGTGTACCTGAGGT|CTCATCGTCAAGTAAGCAGGGACCCAGCTC
ATGGGTTTGGAGTAGAAGGTATCATGCTCA|TACTCTATTGAACCAGGACACCATAAATGT
ACCCTCGCGAGCGCCAAGCGACGAGCCATG|CCCTCGCGAGCGCCAAGCGACGAGCCACGT
CATACTGGCAGCAACACCCTCGCGAGCGCC|CTCGCGAGCGCCAAGCGACGAGCCACGCCA
GGGGCGGAACGAGACTAGATTGCGCGAGCC|GACGAGCCAGATGTGGATTCACGCAGTAAA
AAAGTTCTGATCGACACCCTCGCGAGCGCC|CTCGATTCACTGCATGAGCCCACGCATACT
TTCCATAACTCGACAACTTTTATGATGGCT|TACACGATGAGTAGTAGGGAAACTATTTTT
ACACGATGAGTAGTAGGGAAACTATTTTTA|GAGTAGAAGGTATCATGCTCAGGGTGATAG
GCGCCAAGCGACGAGCCAGATGTGGATTCA|TTATGGCGTCGTGACCTCATGAATCCGTTT
GCCTCGCTAATGTAACCTGCGAAGCTTCGA|TCGACAACTTTTATGATGGCTTGATCTACC
CAGTCCCATTGAGTGTACCTGAGGTGGGTC|CGTCAAGTAAGCAGGGACCCAGCTCCGAAC
CACCTCCGTAGGTTCATGGCTAATAGAAAG|CATGAATACACCTAGCTCGGTTTCTGCAAA
ACGAGCCACATCACGGGGCGGAACGAGACT|CGCGAGCGCCAAGCGACGAGCCAGATGTGG
CTTGGGTGCTGGTTCGAAGCCCAAACGGAT|TGCCTGAAAGCAGACGTAAAACCCGACACC
CTCGCGAGCGCCAAGCGACGAGCCACTACG|CCCACGCATACTGGCAGCAACACCCTCGCG
CAAGCGACGAGCCAGCCAAGCGACGAGCCA|CCAAACGGATGTTATCGATCCCTTAGCGTC
CACCAGTGTGTGGTCGCGATGAGTGCCAAT|GTGGGCGTGTCTGCACATACCCCATCGCTT
CCAAGCGACGAGCCACGCCAAGCGACGAGC|CACGGGGCGGAACGAGACTAGATTGCGCGA
AGTGTGTGGTCGCGATGAGTGCCAATGCAA|GCGTGTCTGCACATACCCCATCGCTTCGAC
TGTGCTCCGGCTGCCACTAGCGGATTGCCG|CTAATGCCGGGACCGTTGCAACCCCTCGAT
GTATGGTAACACCCTCGCGAGCGCCAAGCG|GCAAATCGACACCCTCGCGAGCGCCAAGCG
CAAGCGACGAGCCAGGTCTGCTTACACACC|TCGCGAGCGCCAAGCGACGAGCCAGAATCA
CAAGTAAGCAGGGACCCAGCTCCGAACATG|CCCTCGCGAGCACACCCTCGCGAGCGCCAA
GAGCGCCAAGCGACGAGCCAGCCAAGCGAC|CGAAGCCCAAACGGATGTTATCGATCCCTT
AAGCGACGAGCCACTCAGTGTGCTATCCGC|GTATCCATAAGGTTCTCCTAACTTTCCATA
ACGAGCCATGCTTCCTGCCTGGCAAATCGA|CGAGCCACGTAATACACCCTCGCGAGCGCC
CGAGCGCCAAGCGACGAGCCACGGGTATCC|GTCGGCCACTGCGTAGCTAGGGAACTAGAC
TTTTATGATGGCTTGATCTACCCTTTACTC|GGAAACTATTTTTAGTAGCGAATTTCACAC
CCACTAGCGGATTGCCGGGCGACAATGGGT|CGTTGCAACCCCTCGATAACTTAATACTCT
GGCAAATCGACACCCTCGCGAGCGCCAAGC|CGCGAGCGCCAAGCGACGAGCCACGGGTAT
CTCATCGTCAAGTAAGCAGGGACCCAGCTC|CATATACACCCTCGCGAGCACACCCTCGCG
TCGCGAGCGCCAAGCGACGAGCCACTACGC|CCACGCATACTGGCAGCAACACCCTCGCGA
GGGAACTAGACCCAACACACTAGTGCTATA|TAGCGGATTGCCGGGCGACAATGGGTTTGG
GGTGCTGGTTCGAAGCCCAAACGGATGTTA|TGAAAGCAGACGTAAAACCCGACACCCTCG
TATGATGGCTTGATCTACCCTTTACTCCGT|AACTATTTTTAGTAGCGAATTTCACACCAG
CTAATGTAACCTGCGAAGCTTCGACACCCT|ACTTTTATGATGGCTTGATCTACCCTTTAC
ACACCCTCGCGAGCGCCAAGCGACGAGCCA|CCTTTACTCCGTGCCTGCAGGGCCAACTCA
ACACCTAGCTCGGTTTCTGCAAATCTCGAT|ACGAGCCAGCCAAGCGACGAGCCAGCGTCA
TCAGTGTGCTATCCGCCGGCCTCGCTAATG|CTCCTAACTTTCCATAACTCGACAACTTTT
AGCGACGAGCCAGCGTCAACACCCTCGCGA|TCCCTTAGCGTCTACACCCTCGCGAGCGCC
CGGATGTTATCGATCCCTTAGCGTCTACAC|ACACCCTCGCGAGCGCCAAGCGACGAGCCA
GTATCATGCTCAGGGTGATAGCATCCGCTG|CACCATAAATGTACCATTAGCATGTTAATC
CTGCCTGGCAAATCGACACCCTCGCGAGCG|CACCCTCGCGAGCGCCAAGCGACGAGCCAC
CGAAGCTTCGACACCCTCGCGAGCGCCAAG|CTTGATCTACCCTTTACTCCGTGCCTGCAG
CACCCTCGCGAGCGCCAAGCGACGAGCCAT|GCGACGAGCCACGCCAAGCGACGAGCCACT
GCCACTCACCTCTCTTCTCTTGGGTGCTGG|GAGCCTCGGAACACAAAGTGCCTGAAAGCA
CAGTAAACACCCTCGCGAGCGCCAAGCGAC|ACCCACACCCTCGCGAGCGCCAAGCGACGA
ATGGCTAATAGAAAGCAAAGTTCTGATCGA|CTCGGTTTCTGCAAATCTCGATTCACTGCA
GCGCCAAGCGACGAGCCAGACTTACTCGGG|GCCAAGCGACGAGCCATGCTTCCTGCCTGG
CAAAGTGCCTGAAAGCAGACGTAAAACCCG|CGAGCGCCAAGCGACGAGCCAGACTTACTC
TCCATAAGGTTCTCCTAACTTTCCATAACT|GACCCAACACACTAGTGCTATACACGATGA
AGCCACGGGTATCCATAAGGTTCTCCTAAC|CTAGGGAACTAGACCCAACACACTAGTGCT
GACACCCTCGCGAGCGCCAAGCGACGAGCC|CCAAGCGACGAGCCACGGGTATCCATAAGG
TCGCGAGCGCCAAGCGACGAGCCAGACTTA|GCGAGCGCCAAGCGACGAGCCATGCTTCCT
TGTGCTATCCGCCGGCCTCGCTAATGTAAC|TAACTTTCCATAACTCGACAACTTTTATGA
GCGACGAGCCACGTAATACACCCTCGCGAG|GGGCCAACTCACGGACGCCCACCGATGTCG
CGAGCCAGGTCTGCTTACACACCCTCGCGA|CGCCAAGCGACGAGCCAGAATCAGGGATTA
TGGGTCACCTCCGTAGGTTCATGGCTAATA|CCGAACATGAATACACCTAGCTCGGTTTCT
GCGACGAGCCATATACACCCTCGCGAGCAC|CGACGAGCCACTCACCTCTCTTCTCTTGGG
CGACGAGCCACGCCAAGCGACGAGCCACTC|GGCGGAACGAGACTAGATTGCGCGAGCCTC
CACCCTCGCGAGCGCCAAGCGACGAGCCAC|CCAGGTCTGCTTACACACCCTCGCGAGCGC
AGACACCCTCGCGAGCGCCAAGCGACGAGC|CAAGCGACGAGCCACATCACGGGGCGGAAC
CACGATGAGTAGTAGGGAAACTATTTTTAG|AGTAGAAGGTATCATGCTCAGGGTGATAGC
CGAAGCCCAAACGGATGTTATCGATCCCTT|CGTAAAACCCGACACCCTCGCGAGCGCCAA
GACGAGCCACGGGTATCCATAAGGTTCTCC|GTAGCTAGGGAACTAGACCCAACACACTAG
ATTGCCGGGCGACAATGGGTTTGGAGTAGA|CCTCGATAACTTAATACTCTATTGAACCAG
CGTAGGTTCATGGCTAATAGAAAGCAAAGT|TACACCTAGCTCGGTTTCTGCAAATCTCGA
AAGCGACGAGCCAGAATCAGGGATTATTAT|AAGCGACGAGCCACTCAGTGTGCTATCCGC
CAAGCGACGAGCCATGCTTCCTGCCTGGCA|AAGCGACGAGCCACGTAATACACCCTCGCG
AGCCTCGGAACACAAAGTGCCTGAAAGCAG|TAAACACCCTCGCGAGCGCCAAGCGACGAG
CATGCTCAGGGTGATAGCATCCGCTGTTGA|ATAAATGTACCATTAGCATGTTAATCCGGA
TTTCTAGTTGCAGTCCCATTGAGTGTACCT|GGTTTCTCATCGTCAAGTAAGCAGGGACCC
GGCGACAATGGGTTTGGAGTAGAAGGTATC|AACTTAATACTCTATTGAACCAGGACACCA
CCAAGCGACGAGCCACTACGCCCACGGCAG|CTGGCAGCAACACCCTCGCGAGCGCCAAGC
CAAGCGACGAGCCACGCCAAGCGACGAGCC|ACGGGGCGGAACGAGACTAGATTGCGCGAG
CACCCTCGCGAGCGCCAAGCGACGAGCCAC|GCGACGAGCCACATCACGGGGCGGAACGAG
GCAAATCGACACCCTCGCGAGCGCCAAGCG|GCGAGCGCCAAGCGACGAGCCACGGGTATC
GGTCGCGATGAGTGCCAATGCAAAGAGGAG|TGCACATACCCCATCGCTTCGACCGGTCGT
GCGACGAGCCAGACTTACTCGGGTATGGTA|GACGAGCCATGCTTCCTGCCTGGCAAATCG
CGCGAGCGCCAAGCGACGAGCCACGGGTAT|ATGTCGGCCACTGCGTAGCTAGGGAACTAG
CAAGCGACGAGCCACGTAATACACCCTCGC|GCAGGGCCAACTCACGGACGCCCACCGATG
GCGAGCCTCGGAACACAAAGTGCCTGAAAG|CAGTAAACACCCTCGCGAGCGCCAAGCGAC
TATGGCGTCGTGACCTCATGAATCCGTTTT|CGCCGGCCTCGCTAATGTAACCTGCGAAGC
CAAGCGACGAGCCACTCACCTCTCTTCTCT|TAGATTGCGCGAGCCTCGGAACACAAAGTG
ACGTAATACACCCTCGCGAGCGCCAAGCGA|ACGGACGCCCACCGATGTCGGCCACTGCGT
GAACGAGACTAGATTGCGCGAGCCTCGGAA|CCAGATGTGGATTCACGCAGTAAACACCCT
TTGCCGGGCGACAATGGGTTTGGAGTAGAA|CTCGATAACTTAATACTCTATTGAACCAGG
GGAACTAGACCCAACACACTAGTGCTATAC|AGCGGATTGCCGGGCGACAATGGGTTTGGA
CCAATGCAAAGAGGAGTGTGCTCCGGCTGC|CGCTTCGACCGGTCGTCTAATGCCGGGACC
ACTGCGTAGCTAGGGAACTAGACCCAACAC|TCCGGCTGCCACTAGCGGATTGCCGGGCGA
AGCTCCGAACATGAATACACCTAGCTCGGT|TCGCGAGCGCCAAGCGACGAGCCAGCCAAG
CGAGCGCCAAGCGACGAGCCATATACACCC|CCACGCCAAGCGACGAGCCACTCACCTCTC
TAGCTAGGGAACTAGACCCAACACACTAGT|TGCCACTAGCGGATTGCCGGGCGACAATGG
GTAAGCAGGGACCCAGCTCCGAACATGAAT|TCGCGAGCACACCCTCGCGAGCGCCAAGCG
AATGTAACCTGCGAAGCTTCGACACCCTCG|TTTTATGATGGCTTGATCTACCCTTTACTC
TGCAGGGCCAACTCACGGACGCCCACCGAT|GTGGTCGCGATGAGTGCCAATGCAAAGAGG
ACACCCTCGCGAGCGCCAAGCGACGAGCCA|AATCAGGGATTATTATGGCGTCGTGACCTC
AGAATCAGGGATTATTATGGCGTCGTGACC|ACTCAGTGTGCTATCCGCCGGCCTCGCTAA
GTAACACCCTCGCGAGCGCCAAGCGACGAG|TCGACACCCTCGCGAGCGCCAAGCGACGAG
GCGCGAGCCTCGGAACACAAAGTGCCTGAA|CGCAGTAAACACCCTCGCGAGCGCCAAGCG
GACCCAACACACTAGTGCTATACACGATGA|TGCCGGGCGACAATGGGTTTGGAGTAGAAG
GTCAAGTAAGCAGGGACCCAGCTCCGAACA|CACCCTCGCGAGCACACCCTCGCGAGCGCC
AGGTTCTCCTAACTTTCCATAACTCGACAA|ACACACTAGTGCTATACACGATGAGTAGTA
GAGCCAGACTTACTCGGGTATGGTAACACC|GCCATGCTTCCTGCCTGGCAAATCGACACC
CGCCAAGCGACGAGCCAGATGTGGATTCAC|TATGGCGTCGTGACCTCATGAATCCGTTTT
TATCCGCCGGCCTCGCTAATGTAACCTGCG|TTCCATAACTCGACAACTTTTATGATGGCT
GTAGGTTCATGGCTAATAGAAAGCAAAGTT|ACACCTAGCTCGGTTTCTGCAAATCTCGAT
GACGAGCCACGCCAAGCGACGAGCCACTCA|GCGGAACGAGACTAGATTGCGCGAGCCTCG
CGGGGCGGAACGAGACTAGATTGCGCGAGC|CGACGAGCCAGATGTGGATTCACGCAGTAA
AAGCGACGAGCCACATCACGGGGCGGAACG|ACCCTCGCGAGCGCCAAGCGACGAGCCAGA
AGGTTCATGGCTAATAGAAAGCAAAGTTCT|ACCTAGCTCGGTTTCTGCAAATCTCGATTC
CACGGGTATCCATAAGGTTCTCCTAACTTT|GGGAACTAGACCCAACACACTAGTGCTATA
CGGAACACAAAGTGCCTGAAAGCAGACGTA|ACCCTCGCGAGCGCCAAGCGACGAGCCAGA
ATGTGGATTCACGCAGTAAACACCCTCGCG|TGAATCCGTTTTGACCCACACCCTCGCGAG
AAGCGACGAGCCAGGTCTGCTTACACACCC|CGCGAGCGCCAAGCGACGAGCCAGAATCAG
AGCACACCCTCGCGAGCGCCAAGCGACGAG|TTGGGTGCTGGTTCGAAGCCCAAACGGATG
ACCGATGTCGGCCACTGCGTAGCTAGGGAA|AAGAGGAGTGTGCTCCGGCTGCCACTAGCG
GTCGCGATGAGTGCCAATGCAAAGAGGAGT|GCACATACCCCATCGCTTCGACCGGTCGTC
GCATACTGGCAGCAACACCCTCGCGAGCGC|CCTCGCGAGCGCCAAGCGACGAGCCACGCC
CCTGAGGTGGGTCACCTCCGTAGGTTCATG|CCCAGCTCCGAACATGAATACACCTAGCTC
AGTAAGCAGGGACCCAGCTCCGAACATGAA|CTCGCGAGCACACCCTCGCGAGCGCCAAGC
CGAGCGCCAAGCGACGAGCCACTCAGTGTG|AGCCACGGGTATCCATAAGGTTCTCCTAAC
AAGTAAGCAGGGACCCAGCTCCGAACATGA|CCTCGCGAGCACACCCTCGCGAGCGCCAAG
AGCCACGTAATACACCCTCGCGAGCGCCAA|ACTCACGGACGCCCACCGATGTCGGCCACT
GACGCCCACCGATGTCGGCCACTGCGTAGC|CAATGCAAAGAGGAGTGTGCTCCGGCTGCC
GAGCGCCAAGCGACGAGCCAGGTCTGCTTA|ACACCCTCGCGAGCGCCAAGCGACGAGCCA
GGTTCATGGCTAATAGAAAGCAAAGTTCTG|CCTAGCTCGGTTTCTGCAAATCTCGATTCA
GTGGGTCACCTCCGTAGGTTCATGGCTAAT|TCCGAACATGAATACACCTAGCTCGGTTTC
TTTCTGCAAATCTCGATTCACTGCATGAGC|GCGACGAGCCAGCGTCAACACCCTCGCGAG
GATTGCGCGAGCCTCGGAACACAAAGTGCC|TTCACGCAGTAAACACCCTCGCGAGCGCCA
GAAGGTATCATGCTCAGGGTGATAGCATCC|AGGACACCATAAATGTACCATTAGCATGTT
GTCGGCCACTGCGTAGCTAGGGAACTAGAC|AGTGTGCTCCGGCTGCCACTAGCGGATTGC
GCCAAGCGACGAGCCATGCTTCCTGCCTGG|CCAAGCGACGAGCCACGTAATACACCCTCG
CGTCGTGACCTCATGAATCCGTTTTGACCC|GCCTCGCTAATGTAACCTGCGAAGCTTCGA
ATGTAACCTGCGAAGCTTCGACACCCTCGC|TTTATGATGGCTTGATCTACCCTTTACTCC
ATGCTTCCTGCCTGGCAAATCGACACCCTC|CGTAATACACCCTCGCGAGCGCCAAGCGAC
ACGAGCCAGAATCAGGGATTATTATGGCGT|ACGAGCCACTCAGTGTGCTATCCGCCGGCC
GCGAGCGCCAAGCGACGAGCCACATCACGG|TGCTTACACACCCTCGCGAGCGCCAAGCGA
AAGGTTCTCCTAACTTTCCATAACTCGACA|AACACACTAGTGCTATACACGATGAGTAGT
AATGGGTTTGGAGTAGAAGGTATCATGCTC|ATACTCTATTGAACCAGGACACCATAAATG
GCGAGCACACCCTCGCGAGCGCCAAGCGAC|CTCTTGGGTGCTGGTTCGAAGCCCAAACGG
GTATCCATAAGGTTCTCCTAACTTTCCATA|CTAGACCCAACACACTAGTGCTATACACGA
ACGCAGTAAACACCCTCGCGAGCGCCAAGC|TTGACCCACACCCTCGCGAGCGCCAAGCGA
GCCAACTCACGGACGCCCACCGATGTCGGC|GCGATGAGTGCCAATGCAAAGAGGAGTGTG
TTCACACCAGTGTGTGGTCGCGATGAGTGC|TTGAGTGGGCGTGTCTGCACATACCCCATC
GTGGTCGCGATGAGTGCCAATGCAAAGAGG|TCTGCACATACCCCATCGCTTCGACCGGTC
TTGACCCACACCCTCGCGAGCGCCAAGCGA|GCTTCGACACCCTCGCGAGCGCCAAGCGAC
AAGCGACGAGCCACGCCAAGCGACGAGCCA|CGGGGCGGAACGAGACTAGATTGCGCGAGC
CTTACACACCCTCGCGAGCGCCAAGCGACG|GCCAGAATCAGGGATTATTATGGCGTCGTG
AGTGCCAATGCAAAGAGGAGTGTGCTCCGG|CCATCGCTTCGACCGGTCGTCTAATGCCGG
CCTCGCGAGCGCCAAGCGACGAGCCAGCCA|CTGGTTCGAAGCCCAAACGGATGTTATCGA
CCTCGCGAGCGCCAAGCGACGAGCCAGAAT|CCTCGCGAGCGCCAAGCGACGAGCCACTCA
CGACGAGCCACTCAGTGTGCTATCCGCCGG|TCCATAAGGTTCTCCTAACTTTCCATAACT
GAACTAGACCCAACACACTAGTGCTATACA|GCGGATTGCCGGGCGACAATGGGTTTGGAG
TTGATCTACCCTTTACTCCGTGCCTGCAGG|TAGTAGCGAATTTCACACCAGTGTGTGGTC
CTCAGTGTGCTATCCGCCGGCCTCGCTAAT|TCTCCTAACTTTCCATAACTCGACAACTTT
TAAGGTTCTCCTAACTTTCCATAACTCGAC|CAACACACTAGTGCTATACACGATGAGTAG
CCGTTTTGACCCACACCCTCGCGAGCGCCA|GCGAAGCTTCGACACCCTCGCGAGCGCCAA
AATCCGTTTTGACCCACACCCTCGCGAGCG|CCTGCGAAGCTTCGACACCCTCGCGAGCGC
AGCGACGAGCCAGCCAAGCGACGAGCCAGC|AAACGGATGTTATCGATCCCTTAGCGTCTA
CTCGCGAGCGCCAAGCGACGAGCCACGCCA|CGAGCCACATCACGGGGCGGAACGAGACTA
AAGCGACGAGCCACGTAATACACCCTCGCG|CAGGGCCAACTCACGGACGCCCACCGATGT
ACACCCTCGCGAGCGCCAAGCGACGAGCCA|CACCCTCGCGAGCGCCAAGCGACGAGCCAC
CGGGCGACAATGGGTTTGGAGTAGAAGGTA|ATAACTTAATACTCTATTGAACCAGGACAC
TCGCGAGCACACCCTCGCGAGCGCCAAGCG|TTCTCTTGGGTGCTGGTTCGAAGCCCAAAC
TGGATTCACGCAGTAAACACCCTCGCGAGC|ATCCGTTTTGACCCACACCCTCGCGAGCGC
ATACACCCTCGCGAGCACACCCTCGCGAGC|CACCTCTCTTCTCTTGGGTGCTGGTTCGAA
AGTGCCTGAAAGCAGACGTAAAACCCGACA|GCGCCAAGCGACGAGCCAGACTTACTCGGG
CGACACCCTCGCGAGCGCCAAGCGACGAGC|GCCAAGCGACGAGCCACGGGTATCCATAAG
ACCCTCGCGAGCGCCAAGCGACGAGCCACT|GAGCCCACGCATACTGGCAGCAACACCCTC
CGACGAGCCACGGGTATCCATAAGGTTCTC|CGTAGCTAGGGAACTAGACCCAACACACTA
TGAATACACCTAGCTCGGTTTCTGCAAATC|AAGCGACGAGCCAGCCAAGCGACGAGCCAG
CGACACCCTCGCGAGCGCCAAGCGACGAGC|TCGGGTATGGTAACACCCTCGCGAGCGCCA
CGCCCACCGATGTCGGCCACTGCGTAGCTA|ATGCAAAGAGGAGTGTGCTCCGGCTGCCAC
CCCTCGCGAGCGCCAAGCGACGAGCCAGAT|CAGGGATTATTATGGCGTCGTGACCTCATG
TAACCTGCGAAGCTTCGACACCCTCGCGAG|ATGATGGCTTGATCTACCCTTTACTCCGTG
AGCGACGAGCCAGGTCTGCTTACACACCCT|GCGAGCGCCAAGCGACGAGCCAGAATCAGG
CGAGCCACGTAATACACCCTCGCGAGCGCC|CAACTCACGGACGCCCACCGATGTCGGCCA
GCCACGCCAAGCGACGAGCCACTCACCTCT|ACGAGACTAGATTGCGCGAGCCTCGGAACA
TTATCGATCCCTTAGCGTCTACACCCTCGC|TCGCGAGCGCCAAGCGACGAGCCAGGTCTG
CCCTCGCGAGCGCCAAGCGACGAGCCACTA|AGCCCACGCATACTGGCAGCAACACCCTCG
CTGGTTCGAAGCCCAAACGGATGTTATCGA|AGCAGACGTAAAACCCGACACCCTCGCGAG
TCGCGATGAGTGCCAATGCAAAGAGGAGTG|CACATACCCCATCGCTTCGACCGGTCGTCT
CTCGGTTTCTGCAAATCTCGATTCACTGCA|GCCAAGCGACGAGCCAGCGTCAACACCCTC
AGCGACGAGCCAGATGTGGATTCACGCAGT|CGTCGTGACCTCATGAATCCGTTTTGACCC
GACGAGCCACGTAATACACCCTCGCGAGCG|GCCAACTCACGGACGCCCACCGATGTCGGC
GGTTTCTCATCGTCAAGTAAGCAGGGACCC|CGAGCCATATACACCCTCGCGAGCACACCC
CACGTAATACACCCTCGCGAGCGCCAAGCG|CACGGACGCCCACCGATGTCGGCCACTGCG
GGTTCTCCTAACTTTCCATAACTCGACAAC|CACACTAGTGCTATACACGATGAGTAGTAG
AAATCGACACCCTCGCGAGCGCCAAGCGAC|GAGCGCCAAGCGACGAGCCACGGGTATCCA
TAGTAGGGAAACTATTTTTAGTAGCGAATT|TATCATGCTCAGGGTGATAGCATCCGCTGT
CCCTCGCGAGCGCCAAGCGACGAGCCACAT|AGGTCTGCTTACACACCCTCGCGAGCGCCA
GAGCCAGAATCAGGGATTATTATGGCGTCG|GAGCCACTCAGTGTGCTATCCGCCGGCCTC
TGAATCCGTTTTGACCCACACCCTCGCGAG|AACCTGCGAAGCTTCGACACCCTCGCGAGC
TTTAGTAGCGAATTTCACACCAGTGTGTGG|ATAGCATCCGCTGTTGAGTGGGCGTGTCTG
GATTCACTGCATGAGCCCACGCATACTGGC|TCAACACCCTCGCGAGACACCCTCGCGAGC
CACGCCAAGCGACGAGCCACTCACCTCTCT|GAGACTAGATTGCGCGAGCCTCGGAACACA
TGCTCCGGCTGCCACTAGCGGATTGCCGGG|AATGCCGGGACCGTTGCAACCCCTCGATAA
TCTTCTTTCTAGTTGCAGTCCCATTGAGTG|CAGTTGGTTTCTCATCGTCAAGTAAGCAGG
CTAGCTCGGTTTCTGCAAATCTCGATTCAC|GCCAGCCAAGCGACGAGCCAGCGTCAACAC
GATGAGTGCCAATGCAAAGAGGAGTGTGCT|TACCCCATCGCTTCGACCGGTCGTCTAATG
ACACCCTCGCGAGCGCCAAGCGACGAGCCA|CCCACCGATGTCGGCCACTGCGTAGCTAGG
AGTCCCATTGAGTGTACCTGAGGTGGGTCA|GTCAAGTAAGCAGGGACCCAGCTCCGAACA
CTAACTTTCCATAACTCGACAACTTTTATG|GTGCTATACACGATGAGTAGTAGGGAAACT
GTAGCTAGGGAACTAGACCCAACACACTAG|CTGCCACTAGCGGATTGCCGGGCGACAATG
AATCGACACCCTCGCGAGCGCCAAGCGACG|AGCGCCAAGCGACGAGCCACGGGTATCCAT
ACACCAGTGTGTGGTCGCGATGAGTGCCAA|AGTGGGCGTGTCTGCACATACCCCATCGCT
CGCGAGCGCCAAGCGACGAGCCATATACAC|AGCCACGCCAAGCGACGAGCCACTCACCTC
AAGCGACGAGCCATATACACCCTCGCGAGC|AGCGACGAGCCACTCACCTCTCTTCTCTTG
AACTTTCCATAACTCGACAACTTTTATGAT|GCTATACACGATGAGTAGTAGGGAAACTAT
CGAGCCACTACGCCCACGGCAGTTGGTTTC|AACACCCTCGCGAGCGCCAAGCGACGAGCC
ATGATGGCTTGATCTACCCTTTACTCCGTG|ACTATTTTTAGTAGCGAATTTCACACCAGT
TCTCTTGGGTGCTGGTTCGAAGCCCAAACG|AAGTGCCTGAAAGCAGACGTAAAACCCGAC
GCGACGAGCCAGCCAAGCGACGAGCCAGCG|AACGGATGTTATCGATCCCTTAGCGTCTAC
AGACTAGATTGCGCGAGCCTCGGAACACAA|TGTGGATTCACGCAGTAAACACCCTCGCGA
GCCACATCACGGGGCGGAACGAGACTAGAT|AGCGCCAAGCGACGAGCCAGATGTGGATTC
ACCCTCGCGAGCGCCAAGCGACGAGCCAGG|GTATGGTAACACCCTCGCGAGCGCCAAGCG
CAAAGAGGAGTGTGCTCCGGCTGCCACTAG|GACCGGTCGTCTAATGCCGGGACCGTTGCA
ACAACTTTTATGATGGCTTGATCTACCCTT|AGTAGGGAAACTATTTTTAGTAGCGAATTT
CTGCCACTAGCGGATTGCCGGGCGACAATG|GACCGTTGCAACCCCTCGATAACTTAATAC
CTCGCGAGCGCCAAGCGACGAGCCATGCTT|TCGCGAGCGCCAAGCGACGAGCCACGTAAT
GGATTCACGCAGTAAACACCCTCGCGAGCG|TCCGTTTTGACCCACACCCTCGCGAGCGCC
AGCGACGAGCCACTACGCCCACGGCAGTTG|GCAGCAACACCCTCGCGAGCGCCAAGCGAC
AGCGCCAAGCGACGAGCCAGATGTGGATTC|ATTATGGCGTCGTGACCTCATGAATCCGTT
AGGGCCAACTCACGGACGCCCACCGATGTC|GTCGCGATGAGTGCCAATGCAAAGAGGAGT
CAGCAACACCCTCGCGAGCGCCAAGCGACG|CGCCAAGCGACGAGCCACGCCAAGCGACGA
ACACACCCTCGCGAGCGCCAAGCGACGAGC|AGAATCAGGGATTATTATGGCGTCGTGACC
CCAACACACTAGTGCTATACACGATGAGTA|CGGGCGACAATGGGTTTGGAGTAGAAGGTA
TGCTATACACGATGAGTAGTAGGGAAACTA|GGTTTGGAGTAGAAGGTATCATGCTCAGGG
AGAAGGTATCATGCTCAGGGTGATAGCATC|CAGGACACCATAAATGTACCATTAGCATGT
TCAACACCCTCGCGAGACACCCTCGCGAGC|ACCCTCGCGAGCGCCAAGCGACGAGCCACA
GCGTCTACACCCTCGCGAGCGCCAAGCGAC|CGACGAGCCAGGTCTGCTTACACACCCTCG
AGCGCCAAGCGACGAGCCAGAATCAGGGAT|AGCGCCAAGCGACGAGCCACTCAGTGTGCT
CGATTCACTGCATGAGCCCACGCATACTGG|GTCAACACCCTCGCGAGACACCCTCGCGAG
AACTAGACCCAACACACTAGTGCTATACAC|CGGATTGCCGGGCGACAATGGGTTTGGAGT
GACGAGCCACATCACGGGGCGGAACGAGAC|TCGCGAGCGCCAAGCGACGAGCCAGATGTG
ACGAGCCACGTAATACACCCTCGCGAGCGC|CCAACTCACGGACGCCCACCGATGTCGGCC
TGTTATCGATCCCTTAGCGTCTACACCCTC|CCTCGCGAGCGCCAAGCGACGAGCCAGGTC
ACTTACTCGGGTATGGTAACACCCTCGCGA|TTCCTGCCTGGCAAATCGACACCCTCGCGA
GACACCCTCGCGAGCGCCAAGCGACGAGCC|CATGAGCCCACGCATACTGGCAGCAACACC
CAGCCAAGCGACGAGCCAGCGTCAACACCC|TATCGATCCCTTAGCGTCTACACCCTCGCG
GACGAGCCAGACTTACTCGGGTATGGTAAC|CGAGCCATGCTTCCTGCCTGGCAAATCGAC
TCCGTTTTGACCCACACCCTCGCGAGCGCC|TGCGAAGCTTCGACACCCTCGCGAGCGCCA
CCAGCGTCAACACCCTCGCGAGACACCCTC|GTCTACACCCTCGCGAGCGCCAAGCGACGA
TATACACGATGAGTAGTAGGGAAACTATTT|TTGGAGTAGAAGGTATCATGCTCAGGGTGA
CGACGAGCCACATCACGGGGCGGAACGAGA|CTCGCGAGCGCCAAGCGACGAGCCAGATGT
TAGCGGATTGCCGGGCGACAATGGGTTTGG|GCAACCCCTCGATAACTTAATACTCTATTG
ACGAGCCACTCAGTGTGCTATCCGCCGGCC|CATAAGGTTCTCCTAACTTTCCATAACTCG
ACATCACGGGGCGGAACGAGACTAGATTGC|GCCAAGCGACGAGCCAGATGTGGATTCACG
GCCACTGCGTAGCTAGGGAACTAGACCCAA|TGCTCCGGCTGCCACTAGCGGATTGCCGGG
CCAAACGGATGTTATCGATCCCTTAGCGTC|ACCCGACACCCTCGCGAGCGCCAAGCGACG
CGTGCCTGCAGGGCCAACTCACGGACGCCC|CAGTGTGTGGTCGCGATGAGTGCCAATGCA
TCCCTTAGCGTCTACACCCTCGCGAGCGCC|CGCCAAGCGACGAGCCAGGTCTGCTTACAC
CCTGCGAAGCTTCGACACCCTCGCGAGCGC|ATGGCTTGATCTACCCTTTACTCCGTGCCT
TAAAACCCGACACCCTCGCGAGCGCCAAGC|GACTTACTCGGGTATGGTAACACCCTCGCG
GCCACGTAATACACCCTCGCGAGCGCCAAG|CTCACGGACGCCCACCGATGTCGGCCACTG
TCCGCCGGCCTCGCTAATGTAACCTGCGAA|CCATAACTCGACAACTTTTATGATGGCTTG
TAGTTGCAGTCCCATTGAGTGTACCTGAGG|TCTCATCGTCAAGTAAGCAGGGACCCAGCT
AGCGTCTACACCCTCGCGAGCGCCAAGCGA|GCGACGAGCCAGGTCTGCTTACACACCCTC
GGAGTGTGCTCCGGCTGCCACTAGCGGATT|TCGTCTAATGCCGGGACCGTTGCAACCCCT
AGGTATCATGCTCAGGGTGATAGCATCCGC|GACACCATAAATGTACCATTAGCATGTTAA
CAGCGTCAACACCCTCGCGAGACACCCTCG|TCTACACCCTCGCGAGCGCCAAGCGACGAG
GAGCCACTCAGTGTGCTATCCGCCGGCCTC|TAAGGTTCTCCTAACTTTCCATAACTCGAC
TCTAGTTGCAGTCCCATTGAGTGTACCTGA|TTTCTCATCGTCAAGTAAGCAGGGACCCAG
AGTGTACCTGAGGTGGGTCACCTCCGTAGG|CAGGGACCCAGCTCCGAACATGAATACACC
TCCGTAGGTTCATGGCTAATAGAAAGCAAA|AATACACCTAGCTCGGTTTCTGCAAATCTC
CGAGCGCCAAGCGACGAGCCAGACTTACTC|AGCGCCAAGCGACGAGCCATGCTTCCTGCC
TGCGTAGCTAGGGAACTAGACCCAACACAC|CGGCTGCCACTAGCGGATTGCCGGGCGACA
CAAGCGACGAGCCAGACTTACTCGGGTATG|AGCGACGAGCCATGCTTCCTGCCTGGCAAA
GCGATGAGTGCCAATGCAAAGAGGAGTGTG|CATACCCCATCGCTTCGACCGGTCGTCTAA
CCCTCGCGAGCGCCAAGCGACGAGCCAGAC|CTCGCGAGCGCCAAGCGACGAGCCATGCTT
CGAGCGCCAAGCGACGAGCCACTACGCCCA|CGCATACTGGCAGCAACACCCTCGCGAGCG
AGCGACGAGCCACATCACGGGGCGGAACGA|CCCTCGCGAGCGCCAAGCGACGAGCCAGAT
CAATGGGTTTGGAGTAGAAGGTATCATGCT|AATACTCTATTGAACCAGGACACCATAAAT
TCGCGAGCGCCAAGCGACGAGCCAGATGTG|GGATTATTATGGCGTCGTGACCTCATGAAT
GGCAGTTGGTTTCTCATCGTCAAGTAAGCA|CAAGCGACGAGCCATATACACCCTCGCGAG
GAGCCAGCCAAGCGACGAGCCAGCGTCAAC|ATGTTATCGATCCCTTAGCGTCTACACCCT
TATGGTAACACCCTCGCGAGCGCCAAGCGA|CAAATCGACACCCTCGCGAGCGCCAAGCGA
TCTTTCTAGTTGCAGTCCCATTGAGTGTAC|TTGGTTTCTCATCGTCAAGTAAGCAGGGAC
CCAAGCGACGAGCCAGCGTCAACACCCTCG|CGATCCCTTAGCGTCTACACCCTCGCGAGC
ACCCTCGCGAGCGCCAAGCGACGAGCCACA|CAGGTCTGCTTACACACCCTCGCGAGCGCC
CGTTTTGACCCACACCCTCGCGAGCGCCAA|CGAAGCTTCGACACCCTCGCGAGCGCCAAG
CCACGCCAAGCGACGAGCCACTCACCTCTC|CGAGACTAGATTGCGCGAGCCTCGGAACAC
AATCAGGGATTATTATGGCGTCGTGACCTC|TCAGTGTGCTATCCGCCGGCCTCGCTAATG
AGCCCAAACGGATGTTATCGATCCCTTAGC|AAAACCCGACACCCTCGCGAGCGCCAAGCG
TGCTTACACACCCTCGCGAGCGCCAAGCGA|GAGCCAGAATCAGGGATTATTATGGCGTCG
CTGAAAGCAGACGTAAAACCCGACACCCTC|AAGCGACGAGCCAGACTTACTCGGGTATGG
GAATACACCTAGCTCGGTTTCTGCAAATCT|AGCGACGAGCCAGCCAAGCGACGAGCCAGC
CCCTCGCGAGCGCCAAGCGACGAGCCAGCC|GCTGGTTCGAAGCCCAAACGGATGTTATCG
CGAGCGCCAAGCGACGAGCCACATCACGGG|GCTTACACACCCTCGCGAGCGCCAAGCGAC
TGAGTGCCAATGCAAAGAGGAGTGTGCTCC|CCCCATCGCTTCGACCGGTCGTCTAATGCC
CACCCTCGCGAGACACCCTCGCGAGCGCCA|TCGCGAGCGCCAAGCGACGAGCCACATCAC
ACCTCCGTAGGTTCATGGCTAATAGAAAGC|ATGAATACACCTAGCTCGGTTTCTGCAAAT
CTGATCGACACCCTCGCGAGCGCCAAGCGA|TCACTGCATGAGCCCACGCATACTGGCAGC
ATCGACACCCTCGCGAGCGCCAAGCGACGA|GCGCCAAGCGACGAGCCACGGGTATCCATA
TCGTGACCTCATGAATCCGTTTTGACCCAC|CTCGCTAATGTAACCTGCGAAGCTTCGACA
GCCAATGCAAAGAGGAGTGTGCTCCGGCTG|TCGCTTCGACCGGTCGTCTAATGCCGGGAC
CCACGTAATACACCCTCGCGAGCGCCAAGC|TCACGGACGCCCACCGATGTCGGCCACTGC
GAATTTCACACCAGTGTGTGGTCGCGATGA|GCTGTTGAGTGGGCGTGTCTGCACATACCC
AGCGCCAAGCGACGAGCCATGCTTCCTGCC|GCGCCAAGCGACGAGCCACGTAATACACCC
CGCCAAGCGACGAGCCATGCTTCCTGCCTG|GCCAAGCGACGAGCCACGTAATACACCCTC
TTGCAGTCCCATTGAGTGTACCTGAGGTGG|CATCGTCAAGTAAGCAGGGACCCAGCTCCG
TCACCTCTCTTCTCTTGGGTGCTGGTTCGA|TCGGAACACAAAGTGCCTGAAAGCAGACGT
CTTAGCGTCTACACCCTCGCGAGCGCCAAG|CAAGCGACGAGCCAGGTCTGCTTACACACC
CACCCTCGCGAGCGCCAAGCGACGAGCCAT|ACCCTCGCGAGCGCCAAGCGACGAGCCACG
GACGAGCCAGATGTGGATTCACGCAGTAAA|CGTGACCTCATGAATCCGTTTTGACCCACA
GGACGCCCACCGATGTCGGCCACTGCGTAG|CCAATGCAAAGAGGAGTGTGCTCCGGCTGC
CTCCGTGCCTGCAGGGCCAACTCACGGACG|CACCAGTGTGTGGTCGCGATGAGTGCCAAT
AGTAGAAGGTATCATGCTCAGGGTGATAGC|AACCAGGACACCATAAATGTACCATTAGCA
TAGGGAACTAGACCCAACACACTAGTGCTA|ACTAGCGGATTGCCGGGCGACAATGGGTTT
GCGAGCGCCAAGCGACGAGCCACGCCAAGC|GCCACATCACGGGGCGGAACGAGACTAGAT
ATGAGCCCACGCATACTGGCAGCAACACCC|CGCGAGACACCCTCGCGAGCGCCAAGCGAC
AGCGACGAGCCACGTAATACACCCTCGCGA|AGGGCCAACTCACGGACGCCCACCGATGTC
CACCCTCGCGAGCGCCAAGCGACGAGCCAC|CTTTACTCCGTGCCTGCAGGGCCAACTCAC
AATAGAAAGCAAAGTTCTGATCGACACCCT|TTCTGCAAATCTCGATTCACTGCATGAGCC
TCTGCTTACACACCCTCGCGAGCGCCAAGC|ACGAGCCAGAATCAGGGATTATTATGGCGT
AGCGCCAAGCGACGAGCCACGCCAAGCGAC|ACATCACGGGGCGGAACGAGACTAGATTGC
CGACGAGCCAGATGTGGATTCACGCAGTAA|TCGTGACCTCATGAATCCGTTTTGACCCAC
GAGCCACGCCAAGCGACGAGCCACTCACCT|GAACGAGACTAGATTGCGCGAGCCTCGGAA
CGAGACACCCTCGCGAGCGCCAAGCGACGA|GCCAAGCGACGAGCCACATCACGGGGCGGA
CTCCTAACTTTCCATAACTCGACAACTTTT|CTAGTGCTATACACGATGAGTAGTAGGGAA
GCGCCAAGCGACGAGCCACTACGCCCACGG|ATACTGGCAGCAACACCCTCGCGAGCGCCA
CGAGCCATATACACCCTCGCGAGCACACCC|GAGCCACTCACCTCTCTTCTCTTGGGTGCT
CGAGCCACGCCAAGCGACGAGCCACTCACC|GGAACGAGACTAGATTGCGCGAGCCTCGGA
CGTCTACACCCTCGCGAGCGCCAAGCGACG|GACGAGCCAGGTCTGCTTACACACCCTCGC
ACAATGGGTTTGGAGTAGAAGGTATCATGC|TAATACTCTATTGAACCAGGACACCATAAA
GCCAAGCGACGAGCCAGAATCAGGGATTAT|GCCAAGCGACGAGCCACTCAGTGTGCTATC
AGTAAACACCCTCGCGAGCGCCAAGCGACG|CCCACACCCTCGCGAGCGCCAAGCGACGAG
AAGCGACGAGCCACTCACCTCTCTTCTCTT|AGATTGCGCGAGCCTCGGAACACAAAGTGC
ATGTTATCGATCCCTTAGCGTCTACACCCT|CCCTCGCGAGCGCCAAGCGACGAGCCAGGT
TAGGGAAACTATTTTTAGTAGCGAATTTCA|CATGCTCAGGGTGATAGCATCCGCTGTTGA
CTTGATCTACCCTTTACTCCGTGCCTGCAG|TTAGTAGCGAATTTCACACCAGTGTGTGGT
GCCCACGCATACTGGCAGCAACACCCTCGC|AGACACCCTCGCGAGCGCCAAGCGACGAGC
GATGAGTAGTAGGGAAACTATTTTTAGTAG|AGAAGGTATCATGCTCAGGGTGATAGCATC
TACACCCTCGCGAGCGCCAAGCGACGAGCC|GCCCACCGATGTCGGCCACTGCGTAGCTAG
TCTCATCGTCAAGTAAGCAGGGACCCAGCT|CCATATACACCCTCGCGAGCACACCCTCGC
ATCGTCAAGTAAGCAGGGACCCAGCTCCGA|ATACACCCTCGCGAGCACACCCTCGCGAGC
GGCGGAACGAGACTAGATTGCGCGAGCCTC|CGAGCCAGATGTGGATTCACGCAGTAAACA
CTGGCAGCAACACCCTCGCGAGCGCCAAGC|CGAGCGCCAAGCGACGAGCCACGCCAAGCG
GCCAAGCGACGAGCCACATCACGGGGCGGA|CACACCCTCGCGAGCGCCAAGCGACGAGCC
CGGCCTCGCTAATGTAACCTGCGAAGCTTC|ACTCGACAACTTTTATGATGGCTTGATCTA
CCATGCTTCCTGCCTGGCAAATCGACACCC|CACGTAATACACCCTCGCGAGCGCCAAGCG
TAGGTTCATGGCTAATAGAAAGCAAAGTTC|CACCTAGCTCGGTTTCTGCAAATCTCGATT
ACCCAGCTCCGAACATGAATACACCTAGCT|ACCCTCGCGAGCGCCAAGCGACGAGCCAGC
CCTCGCGAGCGCCAAGCGACGAGCCAGATG|AGGGATTATTATGGCGTCGTGACCTCATGA
GCAACACCCTCGCGAGCGCCAAGCGACGAG|CCAAGCGACGAGCCACGCCAAGCGACGAGC
CCCTCGCGAGCGCCAAGCGACGAGCCAGAA|CCCTCGCGAGCGCCAAGCGACGAGCCACTC
TCTGCAAATCTCGATTCACTGCATGAGCCC|GACGAGCCAGCGTCAACACCCTCGCGAGAC
CAGGTCTGCTTACACACCCTCGCGAGCGCC|AGCGACGAGCCAGAATCAGGGATTATTATG
CCTAGCTCGGTTTCTGCAAATCTCGATTCA|AGCCAGCCAAGCGACGAGCCAGCGTCAACA
GGCCTCGCTAATGTAACCTGCGAAGCTTCG|CTCGACAACTTTTATGATGGCTTGATCTAC
GTGTGCTCCGGCTGCCACTAGCGGATTGCC|TCTAATGCCGGGACCGTTGCAACCCCTCGA
ACACAAAGTGCCTGAAAGCAGACGTAAAAC|TCGCGAGCGCCAAGCGACGAGCCAGACTTA
AGCCAAGCGACGAGCCAGCGTCAACACCCT|ATCGATCCCTTAGCGTCTACACCCTCGCGA
ACGAGCCACTCACCTCTCTTCTCTTGGGTG|GCGCGAGCCTCGGAACACAAAGTGCCTGAA
GTCTACACCCTCGCGAGCGCCAAGCGACGA|ACGAGCCAGGTCTGCTTACACACCCTCGCG
TTCATGGCTAATAGAAAGCAAAGTTCTGAT|TAGCTCGGTTTCTGCAAATCTCGATTCACT
AGCGGATTGCCGGGCGACAATGGGTTTGGA|CAACCCCTCGATAACTTAATACTCTATTGA
GCCACTACGCCCACGGCAGTTGGTTTCTCA|ACCCTCGCGAGCGCCAAGCGACGAGCCATA
CCTCTCTTCTCTTGGGTGCTGGTTCGAAGC|GAACACAAAGTGCCTGAAAGCAGACGTAAA
GACACCCTCGCGAGCGCCAAGCGACGAGCC|CCCTTTACTCCGTGCCTGCAGGGCCAACTC
CGAGCCAGCCAAGCGACGAGCCAGCGTCAA|GATGTTATCGATCCCTTAGCGTCTACACCC
ACCCACACCCTCGCGAGCGCCAAGCGACGA|TCGACACCCTCGCGAGCGCCAAGCGACGAG
TCGGCCACTGCGTAGCTAGGGAACTAGACC|GTGTGCTCCGGCTGCCACTAGCGGATTGCC
GAATCCGTTTTGACCCACACCCTCGCGAGC|ACCTGCGAAGCTTCGACACCCTCGCGAGCG
GTTCATGGCTAATAGAAAGCAAAGTTCTGA|CTAGCTCGGTTTCTGCAAATCTCGATTCAC
TCAGGGATTATTATGGCGTCGTGACCTCAT|AGTGTGCTATCCGCCGGCCTCGCTAATGTA
AGCCAGCCAAGCGACGAGCCAGCGTCAACA|TGTTATCGATCCCTTAGCGTCTACACCCTC
GGCTAATAGAAAGCAAAGTTCTGATCGACA|CGGTTTCTGCAAATCTCGATTCACTGCATG
GCCGGCCTCGCTAATGTAACCTGCGAAGCT|TAACTCGACAACTTTTATGATGGCTTGATC
CTGCAAATCTCGATTCACTGCATGAGCCCA|ACGAGCCAGCGTCAACACCCTCGCGAGACA
GTCACCTCCGTAGGTTCATGGCTAATAGAA|AACATGAATACACCTAGCTCGGTTTCTGCA
CACTACGCCCACGGCAGTTGGTTTCTCATC|CCTCGCGAGCGCCAAGCGACGAGCCATATA
TGGTTCGAAGCCCAAACGGATGTTATCGAT|GCAGACGTAAAACCCGACACCCTCGCGAGC
CCATTGAGTGTACCTGAGGTGGGTCACCTC|AGTAAGCAGGGACCCAGCTCCGAACATGAA
GAGCCATGCTTCCTGCCTGGCAAATCGACA|AGCCACGTAATACACCCTCGCGAGCGCCAA
ACCTAGCTCGGTTTCTGCAAATCTCGATTC|GAGCCAGCCAAGCGACGAGCCAGCGTCAAC
GGGTGCTGGTTCGAAGCCCAAACGGATGTT|CTGAAAGCAGACGTAAAACCCGACACCCTC
CAAATCTCGATTCACTGCATGAGCCCACGC|AGCCAGCGTCAACACCCTCGCGAGACACCC
AGCCAGACTTACTCGGGTATGGTAACACCC|CCATGCTTCCTGCCTGGCAAATCGACACCC
ACTCACGGACGCCCACCGATGTCGGCCACT|TGAGTGCCAATGCAAAGAGGAGTGTGCTCC
CGAGCGCCAAGCGACGAGCCAGGTCTGCTT|AACACCCTCGCGAGCGCCAAGCGACGAGCC
GGGAAACTATTTTTAGTAGCGAATTTCACA|TGCTCAGGGTGATAGCATCCGCTGTTGAGT
AAACACCCTCGCGAGCGCCAAGCGACGAGC|ACACCCTCGCGAGCGCCAAGCGACGAGCCA
CGCCAAGCGACGAGCCACGTAATACACCCT|CCTGCAGGGCCAACTCACGGACGCCCACCG
AAACGGATGTTATCGATCCCTTAGCGTCTA|CCGACACCCTCGCGAGCGCCAAGCGACGAG
CAGAATCAGGGATTATTATGGCGTCGTGAC|CACTCAGTGTGCTATCCGCCGGCCTCGCTA
GCGTAGCTAGGGAACTAGACCCAACACACT|GGCTGCCACTAGCGGATTGCCGGGCGACAA
ATCACGGGGCGGAACGAGACTAGATTGCGC|CAAGCGACGAGCCAGATGTGGATTCACGCA
CCCTCGCGAGCGCCAAGCGACGAGCCACGG|ACCGATGTCGGCCACTGCGTAGCTAGGGAA
GGCAGCAACACCCTCGCGAGCGCCAAGCGA|AGCGCCAAGCGACGAGCCACGCCAAGCGAC
TGCAGTCCCATTGAGTGTACCTGAGGTGGG|ATCGTCAAGTAAGCAGGGACCCAGCTCCGA
CGGTTTCTGCAAATCTCGATTCACTGCATG|CAAGCGACGAGCCAGCGTCAACACCCTCGC
CCGGCCTCGCTAATGTAACCTGCGAAGCTT|AACTCGACAACTTTTATGATGGCTTGATCT
CTCGCGAGCGCCAAGCGACGAGCCAGGTCT|TGGTAACACCCTCGCGAGCGCCAAGCGACG
GGGCCAACTCACGGACGCCCACCGATGTCG|TCGCGATGAGTGCCAATGCAAAGAGGAGTG
CGACACCCTCGCGAGCGCCAAGCGACGAGC|GCATGAGCCCACGCATACTGGCAGCAACAC
GCCAAGCGACGAGCCACTCAGTGTGCTATC|CGGGTATCCATAAGGTTCTCCTAACTTTCC
CTAGACCCAACACACTAGTGCTATACACGA|GATTGCCGGGCGACAATGGGTTTGGAGTAG
GAGCCACTACGCCCACGGCAGTTGGTTTCT|ACACCCTCGCGAGCGCCAAGCGACGAGCCA
ACTATTTTTAGTAGCGAATTTCACACCAGT|AGGGTGATAGCATCCGCTGTTGAGTGGGCG
GATTCACGCAGTAAACACCCTCGCGAGCGC|CCGTTTTGACCCACACCCTCGCGAGCGCCA
TGTCGGCCACTGCGTAGCTAGGGAACTAGA|GAGTGTGCTCCGGCTGCCACTAGCGGATTG
GTGCCTGAAAGCAGACGTAAAACCCGACAC|CGCCAAGCGACGAGCCAGACTTACTCGGGT
CCTCGGAACACAAAGTGCCTGAAAGCAGAC|AACACCCTCGCGAGCGCCAAGCGACGAGCC
CACTGCGTAGCTAGGGAACTAGACCCAACA|CTCCGGCTGCCACTAGCGGATTGCCGGGCG
CACCCTCGCGAGCGCCAAGCGACGAGCCAC|AAGCGACGAGCCACGGGTATCCATAAGGTT
CGGATTGCCGGGCGACAATGGGTTTGGAGT|ACCCCTCGATAACTTAATACTCTATTGAAC
GGTATCATGCTCAGGGTGATAGCATCCGCT|ACACCATAAATGTACCATTAGCATGTTAAT
AAGAGGAGTGTGCTCCGGCTGCCACTAGCG|CCGGTCGTCTAATGCCGGGACCGTTGCAAC
CCGGGCGACAATGGGTTTGGAGTAGAAGGT|GATAACTTAATACTCTATTGAACCAGGACA
CCAAGCGACGAGCCAGCCAAGCGACGAGCC|CCCAAACGGATGTTATCGATCCCTTAGCGT
AAGCGACGAGCCAGACTTACTCGGGTATGG|GCGACGAGCCATGCTTCCTGCCTGGCAAAT
AAGCAAAGTTCTGATCGACACCCTCGCGAG|AAATCTCGATTCACTGCATGAGCCCACGCA
TATACACCCTCGCGAGCACACCCTCGCGAG|TCACCTCTCTTCTCTTGGGTGCTGGTTCGA
AATCTCGATTCACTGCATGAGCCCACGCAT|CCAGCGTCAACACCCTCGCGAGACACCCTC
TGCCTGGCAAATCGACACCCTCGCGAGCGC|ACCCTCGCGAGCGCCAAGCGACGAGCCACG
GACGAGCCACTACGCCCACGGCAGTTGGTT|GCAACACCCTCGCGAGCGCCAAGCGACGAG
TATTATGGCGTCGTGACCTCATGAATCCGT|ATCCGCCGGCCTCGCTAATGTAACCTGCGA
GCAAATCTCGATTCACTGCATGAGCCCACG|GAGCCAGCGTCAACACCCTCGCGAGACACC
TCGAAGCCCAAACGGATGTTATCGATCCCT|ACGTAAAACCCGACACCCTCGCGAGCGCCA
CAAACGGATGTTATCGATCCCTTAGCGTCT|CCCGACACCCTCGCGAGCGCCAAGCGACGA
GAAAGCAGACGTAAAACCCGACACCCTCGC|GCGACGAGCCAGACTTACTCGGGTATGGTA
CAAATCGACACCCTCGCGAGCGCCAAGCGA|CGAGCGCCAAGCGACGAGCCACGGGTATCC
GACTTACTCGGGTATGGTAACACCCTCGCG|CTTCCTGCCTGGCAAATCGACACCCTCGCG
CCTGCAGGGCCAACTCACGGACGCCCACCG|GTGTGGTCGCGATGAGTGCCAATGCAAAGA
CATGCTTCCTGCCTGGCAAATCGACACCCT|ACGTAATACACCCTCGCGAGCGCCAAGCGA
CGGAACGAGACTAGATTGCGCGAGCCTCGG|AGCCAGATGTGGATTCACGCAGTAAACACC
TGGTCGCGATGAGTGCCAATGCAAAGAGGA|CTGCACATACCCCATCGCTTCGACCGGTCG
CGAGCGCCAAGCGACGAGCCACGCCAAGCG|CCACATCACGGGGCGGAACGAGACTAGATT
ACGGGGCGGAACGAGACTAGATTGCGCGAG|GCGACGAGCCAGATGTGGATTCACGCAGTA
GAGCCACATCACGGGGCGGAACGAGACTAG|CGAGCGCCAAGCGACGAGCCAGATGTGGAT
TCTTCTCTTGGGTGCTGGTTCGAAGCCCAA|ACAAAGTGCCTGAAAGCAGACGTAAAACCC
TCGACAACTTTTATGATGGCTTGATCTACC|AGTAGTAGGGAAACTATTTTTAGTAGCGAA
CATGGCTAATAGAAAGCAAAGTTCTGATCG|GCTCGGTTTCTGCAAATCTCGATTCACTGC
TCGCGAGCGCCAAGCGACGAGCCACGCCAA|GAGCCACATCACGGGGCGGAACGAGACTAG
GTTTCTGCAAATCTCGATTCACTGCATGAG|AGCGACGAGCCAGCGTCAACACCCTCGCGA
TCGCGAGCGCCAAGCGACGAGCCACGGGTA|GATGTCGGCCACTGCGTAGCTAGGGAACTA
CTGCATGAGCCCACGCATACTGGCAGCAAC|CCCTCGCGAGACACCCTCGCGAGCGCCAAG
AAAGCAGACGTAAAACCCGACACCCTCGCG|CGACGAGCCAGACTTACTCGGGTATGGTAA
GCAGTTCTTCTTTCTAGTTGCAGTCCCATT|CACGGCAGTTGGTTTCTCATCGTCAAGTAA
GCCCAAACGGATGTTATCGATCCCTTAGCG|AAACCCGACACCCTCGCGAGCGCCAAGCGA
ACTCGGGTATGGTAACACCCTCGCGAGCGC|TGCCTGGCAAATCGACACCCTCGCGAGCGC
TTTCCATAACTCGACAACTTTTATGATGGC|ATACACGATGAGTAGTAGGGAAACTATTTT
CCAAGCGACGAGCCAGGTCTGCTTACACAC|CTCGCGAGCGCCAAGCGACGAGCCAGAATC
ATCCATAAGGTTCTCCTAACTTTCCATAAC|AGACCCAACACACTAGTGCTATACACGATG
CTGGCAAATCGACACCCTCGCGAGCGCCAA|CTCGCGAGCGCCAAGCGACGAGCCACGGGT
TCACACCAGTGTGTGGTCGCGATGAGTGCC|TGAGTGGGCGTGTCTGCACATACCCCATCG
CCCAAACGGATGTTATCGATCCCTTAGCGT|AACCCGACACCCTCGCGAGCGCCAAGCGAC
CGCCAAGCGACGAGCCATATACACCCTCGC|GCCAAGCGACGAGCCACTCACCTCTCTTCT
CACACCAGTGTGTGGTCGCGATGAGTGCCA|GAGTGGGCGTGTCTGCACATACCCCATCGC
ATTGCGCGAGCCTCGGAACACAAAGTGCCT|TCACGCAGTAAACACCCTCGCGAGCGCCAA
CAGACTTACTCGGGTATGGTAACACCCTCG|TGCTTCCTGCCTGGCAAATCGACACCCTCG
CTAGGGAACTAGACCCAACACACTAGTGCT|CACTAGCGGATTGCCGGGCGACAATGGGTT
CCTCGCGAGCGCCAAGCGACGAGCCACGTA|TACTCCGTGCCTGCAGGGCCAACTCACGGA
TGCATGAGCCCACGCATACTGGCAGCAACA|CCTCGCGAGACACCCTCGCGAGCGCCAAGC
TCCATAACTCGACAACTTTTATGATGGCTT|ACACGATGAGTAGTAGGGAAACTATTTTTA
CAGTGTGCTATCCGCCGGCCTCGCTAATGT|TCCTAACTTTCCATAACTCGACAACTTTTA
GAGCCAGGTCTGCTTACACACCCTCGCGAG|GCCAAGCGACGAGCCAGAATCAGGGATTAT
CCCTCGCGAGCGCCAAGCGACGAGCCACGT|TTACTCCGTGCCTGCAGGGCCAACTCACGG
GACTAGATTGCGCGAGCCTCGGAACACAAA|GTGGATTCACGCAGTAAACACCCTCGCGAG
GCGCCAAGCGACGAGCCACGCCAAGCGACG|CATCACGGGGCGGAACGAGACTAGATTGCG
CGAGCCACTCAGTGTGCTATCCGCCGGCCT|ATAAGGTTCTCCTAACTTTCCATAACTCGA
TAAGCAGGGACCCAGCTCCGAACATGAATA|CGCGAGCACACCCTCGCGAGCGCCAAGCGA
AGTAGTAGGGAAACTATTTTTAGTAGCGAA|GGTATCATGCTCAGGGTGATAGCATCCGCT
CCCTCGCGAGCGCCAAGCGACGAGCCATGC|CCTCGCGAGCGCCAAGCGACGAGCCACGTA
AAACCCGACACCCTCGCGAGCGCCAAGCGA|CTTACTCGGGTATGGTAACACCCTCGCGAG
CACCCTCGCGAGCGCCAAGCGACGAGCCAG|CACCCTCGCGAGCGCCAAGCGACGAGCCAC
CTCGCGAGCACACCCTCGCGAGCGCCAAGC|CTTCTCTTGGGTGCTGGTTCGAAGCCCAAA
GGATGTTATCGATCCCTTAGCGTCTACACC|CACCCTCGCGAGCGCCAAGCGACGAGCCAG
TCCGGCTGCCACTAGCGGATTGCCGGGCGA|GCCGGGACCGTTGCAACCCCTCGATAACTT
GCCAAGCGACGAGCCACTACGCCCACGGCA|ACTGGCAGCAACACCCTCGCGAGCGCCAAG
ATTTCACACCAGTGTGTGGTCGCGATGAGT|TGTTGAGTGGGCGTGTCTGCACATACCCCA
CGGCAGTTGGTTTCTCATCGTCAAGTAAGC|CCAAGCGACGAGCCATATACACCCTCGCGA
CATATACACCCTCGCGAGCACACCCTCGCG|ACTCACCTCTCTTCTCTTGGGTGCTGGTTC
AATTTCACACCAGTGTGTGGTCGCGATGAG|CTGTTGAGTGGGCGTGTCTGCACATACCCC
ACACCCTCGCGAGCGCCAAGCGACGAGCCA|ATGAGCCCACGCATACTGGCAGCAACACCC
GACCCAGCTCCGAACATGAATACACCTAGC|CACCCTCGCGAGCGCCAAGCGACGAGCCAG
GCCAAGCGACGAGCCACGGGTATCCATAAG|CCACTGCGTAGCTAGGGAACTAGACCCAAC
CCAAGCGACGAGCCAGAATCAGGGATTATT|CCAAGCGACGAGCCACTCAGTGTGCTATCC
CTGCAGGGCCAACTCACGGACGCCCACCGA|TGTGGTCGCGATGAGTGCCAATGCAAAGAG
ACTTTTATGATGGCTTGATCTACCCTTTAC|AGGGAAACTATTTTTAGTAGCGAATTTCAC
CGCGAGCGCCAAGCGACGAGCCACATCACG|CTGCTTACACACCCTCGCGAGCGCCAAGCG
TGCTATCCGCCGGCCTCGCTAATGTAACCT|ACTTTCCATAACTCGACAACTTTTATGATG
CTGAGGTGGGTCACCTCCGTAGGTTCATGG|CCAGCTCCGAACATGAATACACCTAGCTCG
TCACGCAGTAAACACCCTCGCGAGCGCCAA|TTTTGACCCACACCCTCGCGAGCGCCAAGC
GCCAGCGTCAACACCCTCGCGAGACACCCT|CGTCTACACCCTCGCGAGCGCCAAGCGACG
TACCCTTTACTCCGTGCCTGCAGGGCCAAC|CGAATTTCACACCAGTGTGTGGTCGCGATG
CGCCAAGCGACGAGCCACTACGCCCACGGC|TACTGGCAGCAACACCCTCGCGAGCGCCAA
ACGAGCCACTACGCCCACGGCAGTTGGTTT|CAACACCCTCGCGAGCGCCAAGCGACGAGC
ACGAGCCAGCGTCAACACCCTCGCGAGACA|TTAGCGTCTACACCCTCGCGAGCGCCAAGC
CTACACCCTCGCGAGCGCCAAGCGACGAGC|GAGCCAGGTCTGCTTACACACCCTCGCGAG
GACAATGGGTTTGGAGTAGAAGGTATCATG|TTAATACTCTATTGAACCAGGACACCATAA
CACCCTCGCGAGCGCCAAGCGACGAGCCAG|ATCAGGGATTATTATGGCGTCGTGACCTCA
GCCACTCAGTGTGCTATCCGCCGGCCTCGC|AGGTTCTCCTAACTTTCCATAACTCGACAA
CCCAGCTCCGAACATGAATACACCTAGCTC|CCCTCGCGAGCGCCAAGCGACGAGCCAGCC
GGGACCCAGCTCCGAACATGAATACACCTA|CACACCCTCGCGAGCGCCAAGCGACGAGCC
TCTGATCGACACCCTCGCGAGCGCCAAGCG|TTCACTGCATGAGCCCACGCATACTGGCAG
TCATGCTCAGGGTGATAGCATCCGCTGTTG|CATAAATGTACCATTAGCATGTTAATCCGG
AGGAGTGTGCTCCGGCTGCCACTAGCGGAT|GTCGTCTAATGCCGGGACCGTTGCAACCCC
ATCGACACCCTCGCGAGCGCCAAGCGACGA|CTGCATGAGCCCACGCATACTGGCAGCAAC
ATCAGGGATTATTATGGCGTCGTGACCTCA|CAGTGTGCTATCCGCCGGCCTCGCTAATGT
CCCATTGAGTGTACCTGAGGTGGGTCACCT|AAGTAAGCAGGGACCCAGCTCCGAACATGA
TGACCCACACCCTCGCGAGCGCCAAGCGAC|CTTCGACACCCTCGCGAGCGCCAAGCGACG
TCGACACCCTCGCGAGCGCCAAGCGACGAG|TACCCTTTACTCCGTGCCTGCAGGGCCAAC
CCTCGCGAGCGCCAAGCGACGAGCCATATA|ACGAGCCACGCCAAGCGACGAGCCACTCAC
CCAGGTCTGCTTACACACCCTCGCGAGCGC|AAGCGACGAGCCAGAATCAGGGATTATTAT
CTCGCGAGCGCCAAGCGACGAGCCAGAATC|CTCGCGAGCGCCAAGCGACGAGCCACTCAG
TGTGTGGTCGCGATGAGTGCCAATGCAAAG|GTGTCTGCACATACCCCATCGCTTCGACCG
TCACGGACGCCCACCGATGTCGGCCACTGC|AGTGCCAATGCAAAGAGGAGTGTGCTCCGG
ACGAGCCAGACTTACTCGGGTATGGTAACA|GAGCCATGCTTCCTGCCTGGCAAATCGACA
CCAAGCGACGAGCCACTCACCTCTCTTCTC|CTAGATTGCGCGAGCCTCGGAACACAAAGT
TATCATGCTCAGGGTGATAGCATCCGCTGT|ACCATAAATGTACCATTAGCATGTTAATCC
AGCCACTCACCTCTCTTCTCTTGGGTGCTG|CGAGCCTCGGAACACAAAGTGCCTGAAAGC
CCCTTTACTCCGTGCCTGCAGGGCCAACTC|AATTTCACACCAGTGTGTGGTCGCGATGAG
AACCTGCGAAGCTTCGACACCCTCGCGAGC|TGATGGCTTGATCTACCCTTTACTCCGTGC
GCGAGCGCCAAGCGACGAGCCAGATGTGGA|ATTATTATGGCGTCGTGACCTCATGAATCC
TCGCGAGCGCCAAGCGACGAGCCACATCAC|TCTGCTTACACACCCTCGCGAGCGCCAAGC
CGCCAAGCGACGAGCCACATCACGGGGCGG|ACACACCCTCGCGAGCGCCAAGCGACGAGC
CACGGCAGTTGGTTTCTCATCGTCAAGTAA|CGCCAAGCGACGAGCCATATACACCCTCGC
ACGGATGTTATCGATCCCTTAGCGTCTACA|GACACCCTCGCGAGCGCCAAGCGACGAGCC
AGAAAGCAAAGTTCTGATCGACACCCTCGC|TGCAAATCTCGATTCACTGCATGAGCCCAC
TGCGCGAGCCTCGGAACACAAAGTGCCTGA|ACGCAGTAAACACCCTCGCGAGCGCCAAGC
TTACACACCCTCGCGAGCGCCAAGCGACGA|CCAGAATCAGGGATTATTATGGCGTCGTGA
CACTGCATGAGCCCACGCATACTGGCAGCA|CACCCTCGCGAGACACCCTCGCGAGCGCCA
GCTATACACGATGAGTAGTAGGGAAACTAT|GTTTGGAGTAGAAGGTATCATGCTCAGGGT
CGCGAGCGCCAAGCGACGAGCCAGGTCTGC|GTAACACCCTCGCGAGCGCCAAGCGACGAG
GGTCACCTCCGTAGGTTCATGGCTAATAGA|GAACATGAATACACCTAGCTCGGTTTCTGC
CCACGGCAGTTGGTTTCTCATCGTCAAGTA|GCGCCAAGCGACGAGCCATATACACCCTCG
GAGCGCCAAGCGACGAGCCACTACGCCCAC|GCATACTGGCAGCAACACCCTCGCGAGCGC
TTTTGACCCACACCCTCGCGAGCGCCAAGC|AAGCTTCGACACCCTCGCGAGCGCCAAGCG
ACACTAGTGCTATACACGATGAGTAGTAGG|GACAATGGGTTTGGAGTAGAAGGTATCATG
CGCGAGCACACCCTCGCGAGCGCCAAGCGA|TCTCTTGGGTGCTGGTTCGAAGCCCAAACG
CGATGTCGGCCACTGCGTAGCTAGGGAACT|GAGGAGTGTGCTCCGGCTGCCACTAGCGGA
ATGCAAAGAGGAGTGTGCTCCGGCTGCCAC|TTCGACCGGTCGTCTAATGCCGGGACCGTT
GCAGGGCCAACTCACGGACGCCCACCGATG|TGGTCGCGATGAGTGCCAATGCAAAGAGGA
CGCCAAGCGACGAGCCAGACTTACTCGGGT|CCAAGCGACGAGCCATGCTTCCTGCCTGGC
TCGGGTATGGTAACACCCTCGCGAGCGCCA|CCTGGCAAATCGACACCCTCGCGAGCGCCA
AGCAGGGACCCAGCTCCGAACATGAATACA|CGAGCACACCCTCGCGAGCGCCAAGCGACG
AGTGTGCTCCGGCTGCCACTAGCGGATTGC|GTCTAATGCCGGGACCGTTGCAACCCCTCG
GTAGTAGGGAAACTATTTTTAGTAGCGAAT|GTATCATGCTCAGGGTGATAGCATCCGCTG
GCCAAGCGACGAGCCATATACACCCTCGCG|CCAAGCGACGAGCCACTCACCTCTCTTCTC
GGCTGCCACTAGCGGATTGCCGGGCGACAA|GGGACCGTTGCAACCCCTCGATAACTTAAT
CCTCGCGAGCGCCAAGCGACGAGCCACGCC|ACGAGCCACATCACGGGGCGGAACGAGACT
CCAAGCGACGAGCCATGCTTCCTGCCTGGC|CAAGCGACGAGCCACGTAATACACCCTCGC
GTCCCATTGAGTGTACCTGAGGTGGGTCAC|TCAAGTAAGCAGGGACCCAGCTCCGAACAT
CGACGAGCCAGCGTCAACACCCTCGCGAGA|CCTTAGCGTCTACACCCTCGCGAGCGCCAA
TTGGGTGCTGGTTCGAAGCCCAAACGGATG|GCCTGAAAGCAGACGTAAAACCCGACACCC
AGCGACGAGCCAGACTTACTCGGGTATGGT|CGACGAGCCATGCTTCCTGCCTGGCAAATC
CGAACATGAATACACCTAGCTCGGTTTCTG|AGCGCCAAGCGACGAGCCAGCCAAGCGACG
CTCGCGAGCGCCAAGCGACGAGCCAGCCAA|TGGTTCGAAGCCCAAACGGATGTTATCGAT
GCGAGACACCCTCGCGAGCGCCAAGCGACG|CGCCAAGCGACGAGCCACATCACGGGGCGG
CTGCGTAGCTAGGGAACTAGACCCAACACA|CCGGCTGCCACTAGCGGATTGCCGGGCGAC
CACACTAGTGCTATACACGATGAGTAGTAG|CGACAATGGGTTTGGAGTAGAAGGTATCAT
GCTTGATCTACCCTTTACTCCGTGCCTGCA|TTTAGTAGCGAATTTCACACCAGTGTGTGG
AGCGCCAAGCGACGAGCCACTCAGTGTGCT|CCACGGGTATCCATAAGGTTCTCCTAACTT
ACTCAGTGTGCTATCCGCCGGCCTCGCTAA|TTCTCCTAACTTTCCATAACTCGACAACTT
TGCCACTAGCGGATTGCCGGGCGACAATGG|ACCGTTGCAACCCCTCGATAACTTAATACT
TGAGGTGGGTCACCTCCGTAGGTTCATGGC|CAGCTCCGAACATGAATACACCTAGCTCGG
TCCGAACATGAATACACCTAGCTCGGTTTC|CGAGCGCCAAGCGACGAGCCAGCCAAGCGA
ACTAGACCCAACACACTAGTGCTATACACG|GGATTGCCGGGCGACAATGGGTTTGGAGTA
CTTTCTAGTTGCAGTCCCATTGAGTGTACC|TGGTTTCTCATCGTCAAGTAAGCAGGGACC
AACCCGACACCCTCGCGAGCGCCAAGCGAC|TTACTCGGGTATGGTAACACCCTCGCGAGC
CACCGATGTCGGCCACTGCGTAGCTAGGGA|AAAGAGGAGTGTGCTCCGGCTGCCACTAGC
TCGTCAAGTAAGCAGGGACCCAGCTCCGAA|TACACCCTCGCGAGCACACCCTCGCGAGCG
CGAGCCAGAATCAGGGATTATTATGGCGTC|CGAGCCACTCAGTGTGCTATCCGCCGGCCT
GAGCGCCAAGCGACGAGCCAGACTTACTCG|GCGCCAAGCGACGAGCCATGCTTCCTGCCT
AGCGCCAAGCGACGAGCCAGGTCTGCTTAC|CACCCTCGCGAGCGCCAAGCGACGAGCCAG
CGCGAGCGCCAAGCGACGAGCCAGATGTGG|GATTATTATGGCGTCGTGACCTCATGAATC
TTATGATGGCTTGATCTACCCTTTACTCCG|AAACTATTTTTAGTAGCGAATTTCACACCA
GCGCCAAGCGACGAGCCAGGTCTGCTTACA|ACCCTCGCGAGCGCCAAGCGACGAGCCAGA
CGAGACTAGATTGCGCGAGCCTCGGAACAC|GATGTGGATTCACGCAGTAAACACCCTCGC
AGGTGGGTCACCTCCGTAGGTTCATGGCTA|GCTCCGAACATGAATACACCTAGCTCGGTT
AAGCGACGAGCCAGCCAAGCGACGAGCCAG|CAAACGGATGTTATCGATCCCTTAGCGTCT
CCACCGATGTCGGCCACTGCGTAGCTAGGG|CAAAGAGGAGTGTGCTCCGGCTGCCACTAG
TTATTATGGCGTCGTGACCTCATGAATCCG|TATCCGCCGGCCTCGCTAATGTAACCTGCG
CCAGCTCCGAACATGAATACACCTAGCTCG|CCTCGCGAGCGCCAAGCGACGAGCCAGCCA
ACGGGTATCCATAAGGTTCTCCTAACTTTC|GGAACTAGACCCAACACACTAGTGCTATAC
CGATGAGTAGTAGGGAAACTATTTTTAGTA|TAGAAGGTATCATGCTCAGGGTGATAGCAT
TCGCGAGCGCCAAGCGACGAGCCAGCCAAG|GGTTCGAAGCCCAAACGGATGTTATCGATC
CGACGAGCCACTACGCCCACGGCAGTTGGT|AGCAACACCCTCGCGAGCGCCAAGCGACGA
TGGTTTCTCATCGTCAAGTAAGCAGGGACC|ACGAGCCATATACACCCTCGCGAGCACACC
GTAGAAGGTATCATGCTCAGGGTGATAGCA|ACCAGGACACCATAAATGTACCATTAGCAT
GGCGTCGTGACCTCATGAATCCGTTTTGAC|CGGCCTCGCTAATGTAACCTGCGAAGCTTC
CCTCGCGAGCGCCAAGCGACGAGCCAGGTC|ATGGTAACACCCTCGCGAGCGCCAAGCGAC
GAGCGCCAAGCGACGAGCCACGGGTATCCA|TCGGCCACTGCGTAGCTAGGGAACTAGACC
CAAGCGACGAGCCAGATGTGGATTCACGCA|GGCGTCGTGACCTCATGAATCCGTTTTGAC
CTCCGTAGGTTCATGGCTAATAGAAAGCAA|GAATACACCTAGCTCGGTTTCTGCAAATCT
ATACACCTAGCTCGGTTTCTGCAAATCTCG|CGACGAGCCAGCCAAGCGACGAGCCAGCGT
ATTTTTAGTAGCGAATTTCACACCAGTGTG|GTGATAGCATCCGCTGTTGAGTGGGCGTGT
CGAGCGCCAAGCGACGAGCCAGCCAAGCGA|TCGAAGCCCAAACGGATGTTATCGATCCCT
CCACTGCGTAGCTAGGGAACTAGACCCAAC|GCTCCGGCTGCCACTAGCGGATTGCCGGGC
CTACCCTTTACTCCGTGCCTGCAGGGCCAA|GCGAATTTCACACCAGTGTGTGGTCGCGAT
TGAGTGTACCTGAGGTGGGTCACCTCCGTA|AGCAGGGACCCAGCTCCGAACATGAATACA
ACTTTCCATAACTCGACAACTTTTATGATG|CTATACACGATGAGTAGTAGGGAAACTATT
GTGCTATCCGCCGGCCTCGCTAATGTAACC|AACTTTCCATAACTCGACAACTTTTATGAT
TCTACACCCTCGCGAGCGCCAAGCGACGAG|CGAGCCAGGTCTGCTTACACACCCTCGCGA
CCGAACATGAATACACCTAGCTCGGTTTCT|GAGCGCCAAGCGACGAGCCAGCCAAGCGAC
CCTCGCGAGCACACCCTCGCGAGCGCCAAG|TCTTCTCTTGGGTGCTGGTTCGAAGCCCAA
CGAGCCAGCGTCAACACCCTCGCGAGACAC|TAGCGTCTACACCCTCGCGAGCGCCAAGCG
CAAGCGACGAGCCACATCACGGGGCGGAAC|CACCCTCGCGAGCGCCAAGCGACGAGCCAG
AAAGTGCCTGAAAGCAGACGTAAAACCCGA|GAGCGCCAAGCGACGAGCCAGACTTACTCG
CACACCCTCGCGAGCGCCAAGCGACGAGCC|GGGTGCTGGTTCGAAGCCCAAACGGATGTT
GAGCGCCAAGCGACGAGCCAGAATCAGGGA|GAGCGCCAAGCGACGAGCCACTCAGTGTGC
TTTGACCCACACCCTCGCGAGCGCCAAGCG|AGCTTCGACACCCTCGCGAGCGCCAAGCGA
ACCTGAGGTGGGTCACCTCCGTAGGTTCAT|ACCCAGCTCCGAACATGAATACACCTAGCT
TAGCGTCTACACCCTCGCGAGCGCCAAGCG|AGCGACGAGCCAGGTCTGCTTACACACCCT
GCGCCAAGCGACGAGCCATATACACCCTCG|CGCCAAGCGACGAGCCACTCACCTCTCTTC
CTCGGGTATGGTAACACCCTCGCGAGCGCC|GCCTGGCAAATCGACACCCTCGCGAGCGCC
CTGCTTACACACCCTCGCGAGCGCCAAGCG|CGAGCCAGAATCAGGGATTATTATGGCGTC
ACGAGCCAGGTCTGCTTACACACCCTCGCG|GCGCCAAGCGACGAGCCAGAATCAGGGATT
GCGACGAGCCAGGTCTGCTTACACACCCTC|CGAGCGCCAAGCGACGAGCCAGAATCAGGG
AGCCATGCTTCCTGCCTGGCAAATCGACAC|GCCACGTAATACACCCTCGCGAGCGCCAAG
GCGCCAAGCGACGAGCCACTCAGTGTGCTA|CACGGGTATCCATAAGGTTCTCCTAACTTT
AGCGACGAGCCACGCCAAGCGACGAGCCAC|GGGGCGGAACGAGACTAGATTGCGCGAGCC
TTTCACACCAGTGTGTGGTCGCGATGAGTG|GTTGAGTGGGCGTGTCTGCACATACCCCAT
CGTAATACACCCTCGCGAGCGCCAAGCGAC|CGGACGCCCACCGATGTCGGCCACTGCGTA
TACTGGCAGCAACACCCTCGCGAGCGCCAA|CGCGAGCGCCAAGCGACGAGCCACGCCAAG
CGAGCGCCAAGCGACGAGCCATGCTTCCTG|GAGCGCCAAGCGACGAGCCACGTAATACAC
GATGTCGGCCACTGCGTAGCTAGGGAACTA|AGGAGTGTGCTCCGGCTGCCACTAGCGGAT
GGGCGGAACGAGACTAGATTGCGCGAGCCT|ACGAGCCAGATGTGGATTCACGCAGTAAAC
ACGAGCCACGCCAAGCGACGAGCCACTCAC|CGGAACGAGACTAGATTGCGCGAGCCTCGG
CCACTACGCCCACGGCAGTTGGTTTCTCAT|CCCTCGCGAGCGCCAAGCGACGAGCCATAT
ATTCACGCAGTAAACACCCTCGCGAGCGCC|CGTTTTGACCCACACCCTCGCGAGCGCCAA
CGTAGCTAGGGAACTAGACCCAACACACTA|GCTGCCACTAGCGGATTGCCGGGCGACAAT
TCATCGTCAAGTAAGCAGGGACCCAGCTCC|ATATACACCCTCGCGAGCACACCCTCGCGA
AGGGACCCAGCTCCGAACATGAATACACCT|GCACACCCTCGCGAGCGCCAAGCGACGAGC
CAGTTGGTTTCTCATCGTCAAGTAAGCAGG|AGCGACGAGCCATATACACCCTCGCGAGCA
TTCTTCTTTCTAGTTGCAGTCCCATTGAGT|GCAGTTGGTTTCTCATCGTCAAGTAAGCAG
CTAGCGGATTGCCGGGCGACAATGGGTTTG|TGCAACCCCTCGATAACTTAATACTCTATT
CAAGCGACGAGCCACTACGCCCACGGCAGT|TGGCAGCAACACCCTCGCGAGCGCCAAGCG
TGCTGGTTCGAAGCCCAAACGGATGTTATC|AAAGCAGACGTAAAACCCGACACCCTCGCG
CGCGATGAGTGCCAATGCAAAGAGGAGTGT|ACATACCCCATCGCTTCGACCGGTCGTCTA
GGTAACACCCTCGCGAGCGCCAAGCGACGA|ATCGACACCCTCGCGAGCGCCAAGCGACGA
AGCGACGAGCCATATACACCCTCGCGAGCA|GCGACGAGCCACTCACCTCTCTTCTCTTGG
GAGCGCCAAGCGACGAGCCATATACACCCT|CACGCCAAGCGACGAGCCACTCACCTCTCT
GCCCACCGATGTCGGCCACTGCGTAGCTAG|TGCAAAGAGGAGTGTGCTCCGGCTGCCACT
CCAACTCACGGACGCCCACCGATGTCGGCC|CGATGAGTGCCAATGCAAAGAGGAGTGTGC
AAGTTCTGATCGACACCCTCGCGAGCGCCA|TCGATTCACTGCATGAGCCCACGCATACTG
GACACCCTCGCGAGCGCCAAGCGACGAGCC|AAGCGACGAGCCACATCACGGGGCGGAACG
AGCGACGAGCCAGAATCAGGGATTATTATG|AGCGACGAGCCACTCAGTGTGCTATCCGCC
CGCCAAGCGACGAGCCAGGTCTGCTTACAC|CCCTCGCGAGCGCCAAGCGACGAGCCAGAA
GTTTGGAGTAGAAGGTATCATGCTCAGGGT|CTATTGAACCAGGACACCATAAATGTACCA
CGACGAGCCACGTAATACACCCTCGCGAGC|GGCCAACTCACGGACGCCCACCGATGTCGG
CACCCTCGCGAGCGCCAAGCGACGAGCCAG|GTGCTGGTTCGAAGCCCAAACGGATGTTAT
AGCCACTACGCCCACGGCAGTTGGTTTCTC|CACCCTCGCGAGCGCCAAGCGACGAGCCAT
TAACTTTCCATAACTCGACAACTTTTATGA|TGCTATACACGATGAGTAGTAGGGAAACTA
TACCTGAGGTGGGTCACCTCCGTAGGTTCA|GACCCAGCTCCGAACATGAATACACCTAGC
AGGGAACTAGACCCAACACACTAGTGCTAT|CTAGCGGATTGCCGGGCGACAATGGGTTTG
ATGTCGGCCACTGCGTAGCTAGGGAACTAG|GGAGTGTGCTCCGGCTGCCACTAGCGGATT
GATCTACCCTTTACTCCGTGCCTGCAGGGC|GTAGCGAATTTCACACCAGTGTGTGGTCGC
GTGTGCTATCCGCCGGCCTCGCTAATGTAA|CTAACTTTCCATAACTCGACAACTTTTATG
CAGTTCTTCTTTCTAGTTGCAGTCCCATTG|ACGGCAGTTGGTTTCTCATCGTCAAGTAAG
ACGAGCCAGCCAAGCGACGAGCCAGCGTCA|GGATGTTATCGATCCCTTAGCGTCTACACC
AAAACCCGACACCCTCGCGAGCGCCAAGCG|ACTTACTCGGGTATGGTAACACCCTCGCGA
GTTCTCCTAACTTTCCATAACTCGACAACT|ACACTAGTGCTATACACGATGAGTAGTAGG
GGAGTAGAAGGTATCATGCTCAGGGTGATA|TGAACCAGGACACCATAAATGTACCATTAG
GGAACACAAAGTGCCTGAAAGCAGACGTAA|CCCTCGCGAGCGCCAAGCGACGAGCCAGAC
CATAACTCGACAACTTTTATGATGGCTTGA|ACGATGAGTAGTAGGGAAACTATTTTTAGT
TCCTGCCTGGCAAATCGACACCCTCGCGAG|TACACCCTCGCGAGCGCCAAGCGACGAGCC
AACGAGACTAGATTGCGCGAGCCTCGGAAC|CAGATGTGGATTCACGCAGTAAACACCCTC
AGCGCCAAGCGACGAGCCAGCCAAGCGACG|GAAGCCCAAACGGATGTTATCGATCCCTTA
CCTTTACTCCGTGCCTGCAGGGCCAACTCA|ATTTCACACCAGTGTGTGGTCGCGATGAGT
TGCTTCCTGCCTGGCAAATCGACACCCTCG|GTAATACACCCTCGCGAGCGCCAAGCGACG
GCCAGACTTACTCGGGTATGGTAACACCCT|CATGCTTCCTGCCTGGCAAATCGACACCCT
GACCTCATGAATCCGTTTTGACCCACACCC|CTAATGTAACCTGCGAAGCTTCGACACCCT
CACCCTCGCGAGCGCCAAGCGACGAGCCAG|CCCTCGCGAGCGCCAAGCGACGAGCCATGC
TCGATCCCTTAGCGTCTACACCCTCGCGAG|CGAGCGCCAAGCGACGAGCCAGGTCTGCTT
AGCGACGAGCCACTCACCTCTCTTCTCTTG|GATTGCGCGAGCCTCGGAACACAAAGTGCC
TGTGGATTCACGCAGTAAACACCCTCGCGA|GAATCCGTTTTGACCCACACCCTCGCGAGC
GTTGCAGTCCCATTGAGTGTACCTGAGGTG|TCATCGTCAAGTAAGCAGGGACCCAGCTCC
CGCGAGCGCCAAGCGACGAGCCACTCAGTG|CGAGCCACGGGTATCCATAAGGTTCTCCTA
CACGGACGCCCACCGATGTCGGCCACTGCG|GTGCCAATGCAAAGAGGAGTGTGCTCCGGC
CACCTCTCTTCTCTTGGGTGCTGGTTCGAA|CGGAACACAAAGTGCCTGAAAGCAGACGTA
CGAGCGCCAAGCGACGAGCCAGATGTGGAT|TTATTATGGCGTCGTGACCTCATGAATCCG
CGGACGCCCACCGATGTCGGCCACTGCGTA|GCCAATGCAAAGAGGAGTGTGCTCCGGCTG
CCCGACACCCTCGCGAGCGCCAAGCGACGA|ACTCGGGTATGGTAACACCCTCGCGAGCGC
AGCGAATTTCACACCAGTGTGTGGTCGCGA|TCCGCTGTTGAGTGGGCGTGTCTGCACATA
TACACACCCTCGCGAGCGCCAAGCGACGAG|CAGAATCAGGGATTATTATGGCGTCGTGAC
ACTACGCCCACGGCAGTTGGTTTCTCATCG|CTCGCGAGCGCCAAGCGACGAGCCATATAC
GCTCCGGCTGCCACTAGCGGATTGCCGGGC|ATGCCGGGACCGTTGCAACCCCTCGATAAC
CGAGCGCCAAGCGACGAGCCACGTAATACA|CGTGCCTGCAGGGCCAACTCACGGACGCCC
CCTCGCGAGCGCCAAGCGACGAGCCACTAC|GCCCACGCATACTGGCAGCAACACCCTCGC
CCGACACCCTCGCGAGCGCCAAGCGACGAG|CTCGGGTATGGTAACACCCTCGCGAGCGCC
GCGCCAAGCGACGAGCCACGTAATACACCC|GCCTGCAGGGCCAACTCACGGACGCCCACC
CTCGCGAGCGCCAAGCGACGAGCCACTCAG|GACGAGCCACGGGTATCCATAAGGTTCTCC
GACGAGCCATATACACCCTCGCGAGCACAC|ACGAGCCACTCACCTCTCTTCTCTTGGGTG
GACCCACACCCTCGCGAGCGCCAAGCGACG|TTCGACACCCTCGCGAGCGCCAAGCGACGA
CCGGCTGCCACTAGCGGATTGCCGGGCGAC|CCGGGACCGTTGCAACCCCTCGATAACTTA
TGAAAGCAGACGTAAAACCCGACACCCTCG|AGCGACGAGCCAGACTTACTCGGGTATGGT
CACCCTCGCGAGCACACCCTCGCGAGCGCC|CTCTCTTCTCTTGGGTGCTGGTTCGAAGCC
ACGGCAGTTGGTTTCTCATCGTCAAGTAAG|GCCAAGCGACGAGCCATATACACCCTCGCG
ATTATTATGGCGTCGTGACCTCATGAATCC|CTATCCGCCGGCCTCGCTAATGTAACCTGC
CAGATGTGGATTCACGCAGTAAACACCCTC|TCATGAATCCGTTTTGACCCACACCCTCGC
